MOIS;THEMATIQUES;TF1;France 2;France 3;Canal +;Arte;M6;Totaux
jan-05;Catastrophes;214;191;88;18;40;49;600
jan-05;Culture-loisirs;27;42;35;4;0;23;131
jan-05;Economie;35;18;10;1;8;11;83
jan-05;Education;14;12;4;3;3;8;44
jan-05;Environnement;31;25;15;1;3;10;85
jan-05;Faits divers;24;19;9;1;1;14;68
jan-05;Histoire-hommages;36;38;24;10;23;19;150
jan-05;International;52;61;54;15;108;26;316
jan-05;Justice;20;27;16;11;11;7;92
jan-05;Politique France;27;25;25;6;22;8;113
jan-05;Sante;21;19;15;0;2;12;69
jan-05;Sciences et techniques;28;11;11;4;2;7;63
jan-05;Societe;139;129;65;24;31;53;441
jan-05;Sport;37;49;19;7;0;32;144
feb-05;Catastrophes;42;30;13;4;14;14;117
feb-05;Culture-loisirs;41;66;23;12;5;29;176
feb-05;Economie;46;43;24;2;7;11;133
feb-05;Education;27;31;22;7;7;10;104
feb-05;Environnement;46;25;12;0;6;7;96
feb-05;Faits divers;17;16;13;8;0;10;64
feb-05;Histoire-hommages;14;12;12;1;9;4;52
feb-05;International;100;110;81;26;160;32;509
feb-05;Justice;56;52;43;15;8;26;200
feb-05;Politique France;23;18;13;2;4;6;66
feb-05;Sante;50;41;20;9;6;16;142
feb-05;Sciences et techniques;17;15;10;0;4;4;50
feb-05;Societe;177;132;67;29;27;70;502
feb-05;Sport;54;58;29;18;3;38;200
mar-05;Catastrophes;47;44;27;1;10;20;149
mar-05;Culture-loisirs;48;81;38;14;2;39;222
mar-05;Economie;92;50;27;2;13;14;198
mar-05;Education;33;24;15;3;4;18;97
mar-05;Environnement;57;57;14;4;0;13;145
mar-05;Faits divers;32;28;18;3;9;12;102
mar-05;Histoire-hommages;7;7;1;1;3;0;19
mar-05;International;109;140;104;30;189;47;619
mar-05;Justice;44;60;30;13;21;14;182
mar-05;Politique France;38;22;22;5;5;12;104
mar-05;Sante;69;75;44;14;19;40;261
mar-05;Sciences et techniques;29;27;8;3;3;6;76
mar-05;Societe;217;187;89;34;39;78;644
mar-05;Sport;55;63;31;15;1;46;211
apr-05;Catastrophes;16;17;7;1;2;7;50
apr-05;Culture-loisirs;28;46;21;8;1;20;124
apr-05;Economie;57;38;20;11;17;12;155
apr-05;Education;12;13;7;2;2;7;43
apr-05;Environnement;30;11;6;1;1;10;59
apr-05;Faits divers;20;19;15;4;4;8;70
apr-05;Histoire-hommages;34;34;19;6;13;14;120
apr-05;International;74;82;66;16;130;23;391
apr-05;Justice;33;26;35;19;5;18;136
apr-05;Politique France;31;23;15;5;5;10;89
apr-05;Sante;23;24;18;5;3;8;81
apr-05;Sciences et techniques;13;12;8;1;5;6;45
apr-05;Societe;275;276;154;47;92;118;962
apr-05;Sport;31;26;16;8;1;29;111
may-05;Catastrophes;12;11;7;1;0;8;39
may-05;Culture-loisirs;47;78;42;10;4;40;221
may-05;Economie;74;65;26;8;15;15;203
may-05;Education;24;9;7;1;4;6;51
may-05;Environnement;33;26;9;1;3;7;79
may-05;Faits divers;18;27;21;9;0;12;87
may-05;Histoire-hommages;22;31;17;4;17;13;104
may-05;International;154;216;119;42;220;66;817
may-05;Justice;43;41;26;19;12;17;158
may-05;Politique France;56;57;47;16;13;24;213
may-05;Sante;48;35;22;2;2;22;131
may-05;Sciences et techniques;31;23;6;0;2;7;69
may-05;Societe;176;143;82;27;37;60;525
may-05;Sport;58;61;38;14;0;53;224
jun-05;Catastrophes;37;24;20;1;8;12;102
jun-05;Culture-loisirs;38;47;27;2;0;16;130
jun-05;Economie;54;44;35;2;11;10;156
jun-05;Education;19;22;12;3;2;13;71
jun-05;Environnement;54;46;10;0;10;11;131
jun-05;Faits divers;13;24;19;10;0;11;77
jun-05;Histoire-hommages;3;10;6;0;3;3;25
jun-05;International;95;105;91;14;168;26;499
jun-05;Justice;51;44;31;11;12;20;169
jun-05;Politique France;29;25;21;4;5;5;89
jun-05;Sante;23;32;13;6;1;10;85
jun-05;Sciences et techniques;22;25;3;1;3;4;58
jun-05;Societe;168;134;72;21;26;67;488
jun-05;Sport;53;49;34;12;2;29;179
jul-05;Catastrophes;43;46;15;9;12;13;138
jul-05;Culture-loisirs;47;61;25;2;3;19;157
jul-05;Economie;43;34;25;11;12;13;138
jul-05;Education;9;11;8;2;1;3;34
jul-05;Environnement;42;48;18;3;9;18;138
jul-05;Faits divers;14;11;8;4;1;8;46
jul-05;Histoire-hommages;8;11;9;1;4;4;37
jul-05;International;185;208;134;52;148;72;799
jul-05;Justice;22;23;23;14;17;12;111
jul-05;Politique France;29;31;21;9;8;11;109
jul-05;Sante;21;9;4;1;3;3;41
jul-05;Sciences et techniques;16;24;7;9;9;8;73
jul-05;Societe;89;84;61;28;27;42;331
jul-05;Sport;81;94;55;31;4;55;320
aug-05;Catastrophes;142;169;96;35;48;58;548
aug-05;Culture-loisirs;48;72;31;6;7;23;187
aug-05;Economie;58;58;35;9;5;19;184
aug-05;Education;25;19;12;3;2;15;76
aug-05;Environnement;66;53;27;6;13;16;181
aug-05;Faits divers;34;34;17;10;9;21;125
aug-05;Histoire-hommages;14;15;17;2;12;11;71
aug-05;International;67;81;53;38;176;33;448
aug-05;Justice;15;20;19;4;7;4;69
aug-05;Politique France;16;19;21;8;4;7;75
aug-05;Sante;32;32;12;4;8;13;101
aug-05;Sciences et techniques;26;20;15;7;9;14;91
aug-05;Societe;159;139;116;39;38;54;545
aug-05;Sport;58;69;38;28;4;43;240
sep-05;Catastrophes;115;102;51;19;32;46;365
sep-05;Culture-loisirs;40;55;25;5;1;17;143
sep-05;Economie;63;39;36;21;21;28;208
sep-05;Education;16;19;7;3;0;3;48
sep-05;Environnement;51;34;19;1;5;4;114
sep-05;Faits divers;19;17;15;7;4;14;76
sep-05;Histoire-hommages;7;10;4;4;5;3;33
sep-05;International;65;71;45;25;133;29;368
sep-05;Justice;25;24;20;11;12;13;105
sep-05;Politique France;47;47;46;20;9;19;188
sep-05;Sante;29;21;18;5;4;5;82
sep-05;Sciences et techniques;10;17;8;4;3;5;47
sep-05;Societe;124;102;78;38;32;55;429
sep-05;Sport;41;43;25;11;0;33;153
oct-05;Catastrophes;47;49;30;8;39;22;195
oct-05;Culture-loisirs;42;57;32;7;3;26;167
oct-05;Economie;47;31;18;10;8;7;121
oct-05;Education;15;8;5;1;0;1;30
oct-05;Environnement;22;14;8;3;2;9;58
oct-05;Faits divers;7;11;12;4;3;2;39
oct-05;Histoire-hommages;10;6;8;0;2;5;31
oct-05;International;69;70;59;27;114;29;368
oct-05;Justice;40;40;34;20;16;17;167
oct-05;Politique France;23;21;13;11;3;9;80
oct-05;Sante;63;70;45;15;33;24;250
oct-05;Sciences et techniques;24;22;12;4;7;8;77
oct-05;Societe;153;140;109;39;44;65;550
oct-05;Sport;40;31;23;3;0;25;122
nov-05;Catastrophes;29;22;9;1;13;15;89
nov-05;Culture-loisirs;50;57;43;5;11;19;185
nov-05;Economie;51;40;33;7;10;17;158
nov-05;Education;17;16;8;5;2;3;51
nov-05;Environnement;39;34;15;4;16;13;121
nov-05;Faits divers;24;31;18;15;1;18;107
nov-05;Histoire-hommages;18;12;13;1;4;1;49
nov-05;International;67;74;39;24;127;21;352
nov-05;Justice;45;39;40;18;19;25;186
nov-05;Politique France;32;40;26;13;7;8;126
nov-05;Sante;47;36;26;10;12;16;147
nov-05;Sciences et techniques;20;20;10;1;1;8;60
nov-05;Societe;291;253;203;81;104;116;1048
nov-05;Sport;47;48;22;8;0;33;158
dec-05;Catastrophes;52;42;37;4;12;36;183
dec-05;Culture-loisirs;60;50;30;5;3;18;166
dec-05;Economie;61;64;30;18;9;19;201
dec-05;Education;16;14;5;3;1;4;43
dec-05;Environnement;29;37;14;6;9;8;103
dec-05;Faits divers;17;13;20;7;2;8;67
dec-05;Histoire-hommages;13;12;6;4;3;5;43
dec-05;International;52;67;52;23;107;28;329
dec-05;Justice;32;27;28;12;13;8;120
dec-05;Politique France;24;16;17;5;0;16;78
dec-05;Sante;19;19;12;1;4;7;62
dec-05;Sciences et techniques;30;14;10;2;2;6;64
dec-05;Societe;186;166;104;38;56;60;610
dec-05;Sport;29;27;21;5;2;26;110
jan-06;Catastrophes;43;30;21;6;7;20;127
jan-06;Culture-loisirs;52;63;38;11;4;33;201
jan-06;Economie;47;39;26;8;20;15;155
jan-06;Education;26;12;7;4;2;5;56
jan-06;Environnement;42;46;24;4;8;15;139
jan-06;Faits divers;31;32;20;6;2;18;109
jan-06;Histoire-hommages;10;10;11;6;4;2;43
jan-06;International;79;88;79;31;138;28;443
jan-06;Justice;54;38;34;18;23;28;195
jan-06;Politique France;26;28;26;11;20;10;121
jan-06;Sante;50;42;24;9;27;15;167
jan-06;Sciences et techniques;22;17;17;1;7;9;73
jan-06;Societe;159;142;100;34;43;55;533
jan-06;Sport;40;42;26;5;2;35;150
feb-06;Catastrophes;13;16;7;5;12;13;66
feb-06;Culture-loisirs;42;47;26;11;2;21;149
feb-06;Economie;46;44;18;11;11;18;148
feb-06;Education;6;6;2;0;3;1;18
feb-06;Environnement;32;21;19;8;9;11;100
feb-06;Faits divers;32;28;27;10;7;12;116
feb-06;Histoire-hommages;11;3;2;2;4;1;23
feb-06;International;42;40;45;30;104;20;281
feb-06;Justice;49;44;27;17;17;21;175
feb-06;Politique France;29;21;23;9;11;8;101
feb-06;Sante;99;94;54;29;38;36;350
feb-06;Sciences et techniques;19;12;11;5;3;4;54
feb-06;Societe;124;104;76;40;55;58;457
feb-06;Sport;45;69;42;5;5;42;208
mar-06;Catastrophes;25;18;7;4;3;7;64
mar-06;Culture-loisirs;46;48;28;12;2;16;152
mar-06;Economie;37;29;18;9;12;7;112
mar-06;Education;37;46;30;9;10;20;152
mar-06;Environnement;40;24;20;4;18;6;112
mar-06;Faits divers;16;8;13;6;3;12;58
mar-06;Histoire-hommages;6;2;5;0;2;1;16
mar-06;International;57;72;41;46;133;30;379
mar-06;Justice;45;38;31;26;34;19;193
mar-06;Politique France;32;16;22;10;3;8;91
mar-06;Sante;59;50;21;12;19;15;176
mar-06;Sciences et techniques;14;15;10;10;7;8;64
mar-06;Societe;211;230;147;60;67;78;793
mar-06;Sport;47;42;23;7;2;23;144
apr-06;Catastrophes;12;9;8;1;13;5;48
apr-06;Culture-loisirs;37;66;24;11;2;16;156
apr-06;Economie;53;51;37;15;10;19;185
apr-06;Education;22;24;16;4;3;9;78
apr-06;Environnement;39;26;13;3;8;9;98
apr-06;Faits divers;19;15;11;4;4;16;69
apr-06;Histoire-hommages;5;9;6;3;4;3;30
apr-06;International;49;80;61;48;140;19;397
apr-06;Justice;33;31;30;15;13;13;135
apr-06;Politique France;20;27;26;6;13;7;99
apr-06;Sante;39;31;29;5;7;12;123
apr-06;Sciences et techniques;25;28;12;9;13;10;97
apr-06;Societe;196;163;112;50;55;67;643
apr-06;Sport;47;53;30;7;1;32;170
may-06;Catastrophes;35;29;17;4;9;11;105
may-06;Culture-loisirs;63;60;43;6;5;23;200
may-06;Economie;64;49;30;14;13;13;183
may-06;Education;23;17;5;1;2;6;54
may-06;Environnement;34;33;18;4;9;11;109
may-06;Faits divers;20;15;16;6;8;16;81
may-06;Histoire-hommages;12;7;9;3;6;7;44
may-06;International;43;66;39;40;146;19;353
may-06;Justice;75;84;78;42;36;39;354
may-06;Politique France;37;35;25;15;17;7;136
may-06;Sante;27;29;19;3;11;10;99
may-06;Sciences et techniques;28;15;14;6;2;5;70
may-06;Societe;157;127;70;52;37;44;487
may-06;Sport;61;50;28;19;4;23;185
jun-06;Catastrophes;10;11;7;3;6;4;41
jun-06;Culture-loisirs;41;41;31;14;0;19;146
jun-06;Economie;33;39;37;11;17;13;150
jun-06;Education;27;20;8;1;1;10;67
jun-06;Environnement;32;23;9;4;6;11;85
jun-06;Faits divers;26;21;20;5;3;13;88
jun-06;Histoire-hommages;7;13;7;1;4;2;34
jun-06;International;41;45;39;38;121;11;295
jun-06;Justice;40;52;38;19;23;23;195
jun-06;Politique France;29;46;31;11;11;16;144
jun-06;Sante;18;15;14;4;5;9;65
jun-06;Sciences et techniques;13;16;12;1;3;2;47
jun-06;Societe;109;120;76;29;40;34;408
jun-06;Sport;218;163;79;26;29;75;590
jul-06;Catastrophes;22;11;12;4;5;10;64
jul-06;Culture-loisirs;41;59;37;9;2;18;166
jul-06;Economie;31;31;17;3;8;9;99
jul-06;Education;9;10;2;2;2;3;28
jul-06;Environnement;46;42;23;2;5;14;132
jul-06;Faits divers;9;17;18;0;0;7;51
jul-06;Histoire-hommages;5;8;6;3;3;1;26
jul-06;International;129;142;103;49;172;49;644
jul-06;Justice;12;19;24;7;8;8;78
jul-06;Politique France;23;18;19;10;6;9;85
jul-06;Sante;29;32;23;9;3;13;109
jul-06;Sciences et techniques;10;15;9;2;8;5;49
jul-06;Societe;82;104;84;29;36;42;377
jul-06;Sport;174;161;96;20;27;83;561
aug-06;Catastrophes;37;42;29;5;14;29;156
aug-06;Culture-loisirs;37;60;32;8;3;16;156
aug-06;Economie;56;45;28;6;8;9;152
aug-06;Education;20;21;8;3;1;8;61
aug-06;Environnement;57;33;35;9;17;10;161
aug-06;Faits divers;22;23;16;4;1;11;77
aug-06;Histoire-hommages;4;4;2;2;7;2;21
aug-06;International;134;134;111;59;172;44;654
aug-06;Justice;13;10;18;2;10;6;59
aug-06;Politique France;37;49;38;21;14;25;184
aug-06;Sante;25;22;13;7;10;10;87
aug-06;Sciences et techniques;27;30;14;3;2;13;89
aug-06;Societe;107;84;78;24;42;43;378
aug-06;Sport;65;58;42;21;1;37;224
sep-06;Catastrophes;29;18;15;3;11;7;83
sep-06;Culture-loisirs;37;55;38;15;1;13;159
sep-06;Economie;49;48;25;10;15;13;160
sep-06;Education;35;25;14;7;4;12;97
sep-06;Environnement;32;29;17;8;10;6;102
sep-06;Faits divers;19;29;23;13;5;14;103
sep-06;Histoire-hommages;10;13;10;0;2;6;41
sep-06;International;93;78;55;36;169;18;449
sep-06;Justice;39;34;32;19;14;20;158
sep-06;Politique France;63;51;49;20;14;19;216
sep-06;Sante;35;35;24;9;3;13;119
sep-06;Sciences et techniques;28;13;18;4;7;9;79
sep-06;Societe;134;113;80;36;41;53;457
sep-06;Sport;47;42;15;11;0;28;143
oct-06;Catastrophes;32;34;19;7;6;16;114
oct-06;Culture-loisirs;58;77;36;13;7;18;209
oct-06;Economie;57;44;27;8;21;15;172
oct-06;Education;28;18;8;0;0;2;56
oct-06;Environnement;55;32;14;6;9;7;123
oct-06;Faits divers;16;23;12;11;5;20;87
oct-06;Histoire-hommages;6;9;7;0;8;0;30
oct-06;International;59;58;54;35;153;13;372
oct-06;Justice;54;57;44;43;16;24;238
oct-06;Politique France;55;54;50;20;20;21;220
oct-06;Sante;50;45;26;1;5;10;137
oct-06;Sciences et techniques;44;31;11;11;17;13;127
oct-06;Societe;190;153;131;54;80;73;681
oct-06;Sport;55;48;28;22;1;35;189
nov-06;Catastrophes;15;14;6;1;3;3;42
nov-06;Culture-loisirs;36;54;28;19;2;17;156
nov-06;Economie;53;47;22;4;14;14;154
nov-06;Education;22;13;4;0;1;4;44
nov-06;Environnement;30;34;11;1;8;8;92
nov-06;Faits divers;15;20;9;5;1;10;60
nov-06;Histoire-hommages;13;13;6;2;6;4;44
nov-06;International;61;84;54;32;145;19;395
nov-06;Justice;48;54;45;29;20;24;220
nov-06;Politique France;53;53;35;27;13;20;201
nov-06;Sante;23;22;17;5;4;5;76
nov-06;Sciences et techniques;29;12;3;4;7;4;59
nov-06;Societe;142;134;95;30;54;53;508
nov-06;Sport;59;60;33;20;2;32;206
dec-06;Catastrophes;22;26;10;3;13;8;82
dec-06;Culture-loisirs;53;70;34;16;5;16;194
dec-06;Economie;58;45;21;12;14;19;169
dec-06;Education;16;16;9;1;3;6;51
dec-06;Environnement;31;27;14;3;6;4;85
dec-06;Faits divers;33;37;28;12;9;20;139
dec-06;Histoire-hommages;11;16;8;5;11;8;59
dec-06;International;59;61;45;27;124;21;337
dec-06;Justice;32;44;41;14;27;27;185
dec-06;Politique France;36;38;44;17;13;11;159
dec-06;Sante;23;21;13;4;6;6;73
dec-06;Sciences et techniques;19;19;10;5;6;13;72
dec-06;Societe;186;166;116;36;37;46;587
dec-06;Sport;31;47;15;10;1;16;120
jan-07;Catastrophes;55;31;18;11;6;12;133
jan-07;Culture-loisirs;68;80;45;21;2;27;243
jan-07;Economie;49;49;39;11;12;15;175
jan-07;Education;20;7;2;0;2;2;33
jan-07;Environnement;80;69;39;10;14;21;233
jan-07;Faits divers;33;32;34;18;3;26;146
jan-07;Histoire-hommages;33;33;21;5;15;11;118
jan-07;International;86;79;65;52;157;25;464
jan-07;Justice;45;40;27;16;22;13;163
jan-07;Politique France;67;73;70;34;15;42;301
jan-07;Sante;51;39;21;8;7;8;134
jan-07;Sciences et techniques;22;19;4;4;3;1;53
jan-07;Societe;200;156;94;43;60;52;605
jan-07;Sport;59;67;37;17;1;29;210
feb-07;Catastrophes;29;30;16;5;8;12;100
feb-07;Culture-loisirs;59;68;41;20;6;26;220
feb-07;Economie;71;47;43;17;28;18;224
feb-07;Education;20;11;3;0;0;5;39
feb-07;Environnement;61;29;22;8;10;12;142
feb-07;Faits divers;30;15;20;12;3;14;94
feb-07;Histoire-hommages;15;6;6;5;3;5;40
feb-07;International;72;70;38;39;130;26;375
feb-07;Justice;41;31;28;19;26;14;159
feb-07;Politique France;79;79;70;34;16;40;318
feb-07;Sante;39;39;14;6;16;13;127
feb-07;Sciences et techniques;15;17;8;1;1;5;47
feb-07;Societe;128;102;69;24;43;32;398
feb-07;Sport;50;60;34;8;6;20;178
mar-07;Catastrophes;23;18;8;5;6;9;69
mar-07;Culture-loisirs;53;56;27;7;2;12;157
mar-07;Economie;72;34;28;11;16;13;174
mar-07;Education;25;17;6;3;4;3;58
mar-07;Environnement;44;30;10;5;12;8;109
mar-07;Faits divers;25;19;17;6;3;19;89
mar-07;Histoire-hommages;7;4;4;2;1;2;20
mar-07;International;68;66;47;49;123;17;370
mar-07;Justice;44;24;30;24;19;15;156
mar-07;Politique France;96;119;75;49;29;51;419
mar-07;Sante;31;25;14;6;3;6;85
mar-07;Sciences et techniques;33;12;2;5;3;10;65
mar-07;Societe;155;115;80;44;46;47;487
mar-07;Sport;53;63;29;20;0;26;191
apr-07;Catastrophes;19;20;5;6;6;9;65
apr-07;Culture-loisirs;30;30;25;6;0;14;105
apr-07;Economie;37;19;10;5;11;5;87
apr-07;Education;7;6;1;1;2;0;17
apr-07;Environnement;37;24;8;6;9;8;92
apr-07;Faits divers;42;50;40;21;6;27;186
apr-07;Histoire-hommages;15;10;10;6;9;7;57
apr-07;International;62;53;38;52;149;16;370
apr-07;Justice;34;22;22;18;15;14;125
apr-07;Politique France;133;148;118;49;39;74;561
apr-07;Sante;26;23;11;7;0;9;76
apr-07;Sciences et techniques;19;22;13;11;2;6;73
apr-07;Societe;127;107;51;33;32;36;386
apr-07;Sport;46;40;20;13;0;28;147
may-07;Catastrophes;25;21;16;4;1;12;79
may-07;Culture-loisirs;61;73;52;9;4;27;226
may-07;Economie;45;37;16;16;19;14;147
may-07;Education;22;18;6;1;0;3;50
may-07;Environnement;60;52;14;9;10;11;156
may-07;Faits divers;26;19;18;10;0;12;85
may-07;Histoire-hommages;16;8;14;4;10;6;58
may-07;International;108;90;82;55;182;38;555
may-07;Justice;27;29;21;19;21;19;136
may-07;Politique France;148;168;126;49;38;83;612
may-07;Sante;32;14;10;4;1;5;66
may-07;Sciences et techniques;33;12;2;6;7;6;66
may-07;Societe;167;114;89;41;49;58;518
may-07;Sport;58;53;29;24;3;27;194
jun-07;Catastrophes;32;19;8;2;2;4;67
jun-07;Culture-loisirs;38;43;25;20;7;11;144
jun-07;Economie;46;38;24;11;8;5;132
jun-07;Education;27;27;16;8;2;10;90
jun-07;Environnement;38;39;25;12;9;10;133
jun-07;Faits divers;23;14;15;13;0;12;77
jun-07;Histoire-hommages;6;10;4;3;3;2;28
jun-07;International;95;76;68;48;123;30;440
jun-07;Justice;42;47;30;29;17;22;187
jun-07;Politique France;96;97;64;34;18;43;352
jun-07;Sante;27;15;8;8;5;5;68
jun-07;Sciences et techniques;19;11;4;7;4;6;51
jun-07;Societe;137;93;60;55;33;51;429
jun-07;Sport;69;59;34;27;2;28;219
jul-07;Catastrophes;65;59;36;16;20;26;222
jul-07;Culture-loisirs;53;84;55;15;1;24;232
jul-07;Economie;65;49;47;14;29;16;220
jul-07;Education;16;9;7;2;3;5;42
jul-07;Environnement;62;55;24;7;17;27;192
jul-07;Faits divers;28;18;19;10;4;9;88
jul-07;Histoire-hommages;13;8;6;4;4;4;39
jul-07;International;101;75;84;49;168;26;503
jul-07;Justice;58;62;48;37;22;30;257
jul-07;Politique France;48;37;32;7;10;16;150
jul-07;Sante;22;18;15;8;5;14;82
jul-07;Sciences et techniques;23;24;4;10;8;9;78
jul-07;Societe;169;146;90;42;43;69;559
jul-07;Sport;105;112;76;33;10;43;379
aug-07;Catastrophes;69;65;42;17;32;39;264
aug-07;Culture-loisirs;52;45;22;6;7;12;144
aug-07;Economie;57;55;42;15;23;12;204
aug-07;Education;24;21;9;2;1;7;64
aug-07;Environnement;53;36;15;5;8;8;125
aug-07;Faits divers;22;30;22;11;6;16;107
aug-07;Histoire-hommages;15;11;10;4;7;11;58
aug-07;International;52;31;38;37;117;13;288
aug-07;Justice;32;26;19;15;10;8;110
aug-07;Politique France;33;25;27;8;8;13;114
aug-07;Sante;15;7;3;5;8;5;43
aug-07;Sciences et techniques;27;19;18;5;5;9;83
aug-07;Societe;129;127;88;34;53;54;485
aug-07;Sport;89;74;43;27;5;36;274
sep-07;Catastrophes;23;20;13;5;13;7;81
sep-07;Culture-loisirs;46;54;31;18;5;26;180
sep-07;Economie;52;45;29;23;20;11;180
sep-07;Education;21;27;11;7;4;6;76
sep-07;Environnement;34;28;5;5;16;4;92
sep-07;Faits divers;26;28;12;12;4;25;107
sep-07;Histoire-hommages;12;11;10;6;3;6;48
sep-07;International;78;78;37;52;135;23;403
sep-07;Justice;39;30;25;35;13;22;164
sep-07;Politique France;55;42;40;23;14;23;197
sep-07;Sante;25;21;19;7;2;8;82
sep-07;Sciences et techniques;17;11;2;4;1;4;39
sep-07;Societe;123;133;70;52;41;38;457
sep-07;Sport;131;78;47;14;9;39;318
oct-07;Catastrophes;37;26;21;11;11;13;119
oct-07;Culture-loisirs;60;61;42;33;6;32;234
oct-07;Economie;54;46;20;21;13;11;165
oct-07;Education;21;18;8;3;2;7;59
oct-07;Environnement;40;53;20;11;9;9;142
oct-07;Faits divers;37;25;11;12;4;16;105
oct-07;Histoire-hommages;8;5;7;4;8;2;34
oct-07;International;114;114;64;71;178;28;569
oct-07;Justice;68;51;56;52;17;29;273
oct-07;Politique France;50;44;39;19;12;16;180
oct-07;Sante;30;36;9;9;1;9;94
oct-07;Sciences et techniques;22;10;10;1;2;8;53
oct-07;Societe;176;179;88;69;54;61;627
oct-07;Sport;146;118;69;30;7;53;423
nov-07;Catastrophes;29;28;12;10;12;10;101
nov-07;Culture-loisirs;43;41;27;16;3;16;146
nov-07;Economie;44;51;26;29;17;15;182
nov-07;Education;41;40;18;14;8;13;134
nov-07;Environnement;26;24;8;5;9;7;79
nov-07;Faits divers;21;17;20;14;1;14;87
nov-07;Histoire-hommages;16;14;10;5;5;3;53
nov-07;International;103;91;55;56;142;38;485
nov-07;Justice;52;45;43;30;12;28;210
nov-07;Politique France;33;21;15;11;5;3;88
nov-07;Sante;21;6;8;5;2;8;50
nov-07;Sciences et techniques;13;5;6;2;4;4;34
nov-07;Societe;203;192;109;81;50;70;705
nov-07;Sport;51;36;20;13;2;18;140
dec-07;Catastrophes;23;17;14;5;3;2;64
dec-07;Culture-loisirs;68;57;35;17;8;25;210
dec-07;Economie;61;49;38;20;13;18;199
dec-07;Education;17;9;5;1;0;1;33
dec-07;Environnement;56;36;18;10;16;9;145
dec-07;Faits divers;38;33;16;15;4;23;129
dec-07;Histoire-hommages;10;7;4;5;2;2;30
dec-07;International;109;117;69;72;149;48;564
dec-07;Justice;65;51;45;36;16;37;250
dec-07;Politique France;46;35;30;13;10;16;150
dec-07;Sante;24;20;19;8;5;11;87
dec-07;Sciences et techniques;18;12;3;7;5;6;51
dec-07;Societe;159;149;81;63;52;46;550
dec-07;Sport;50;40;19;7;0;17;133
jan-08;Catastrophes;24;14;10;3;2;4;57
jan-08;Culture-loisirs;76;80;53;34;9;33;285
jan-08;Economie;83;89;44;26;29;24;295
jan-08;Education;11;11;5;4;2;2;35
jan-08;Environnement;38;32;16;4;5;7;102
jan-08;Faits divers;45;36;30;17;0;27;155
jan-08;Histoire-hommages;21;15;11;7;9;7;70
jan-08;International;151;144;98;80;212;41;726
jan-08;Justice;58;55;36;32;21;29;231
jan-08;Politique France;72;65;50;21;10;30;248
jan-08;Sante;44;47;30;14;6;16;157
jan-08;Sciences et techniques;19;15;5;3;1;4;47
jan-08;Societe;166;126;73;65;43;67;540
jan-08;Sport;91;81;40;22;3;28;265
feb-08;Catastrophes;15;10;5;3;4;8;45
feb-08;Culture-loisirs;68;72;47;26;9;25;247
feb-08;Economie;73;69;30;27;18;17;234
feb-08;Education;20;13;11;5;2;7;58
feb-08;Environnement;28;13;9;13;3;3;69
feb-08;Faits divers;19;9;11;11;3;16;69
feb-08;Histoire-hommages;15;9;2;5;2;4;37
feb-08;International;103;102;70;73;166;36;550
feb-08;Justice;43;46;32;34;18;20;193
feb-08;Politique France;55;53;53;22;15;26;224
feb-08;Sante;21;21;11;10;3;11;77
feb-08;Sciences et techniques;36;11;5;5;3;9;69
feb-08;Societe;136;96;72;53;35;49;441
feb-08;Sport;56;57;31;17;0;27;188
mar-08;Catastrophes;16;24;10;4;1;6;61
mar-08;Culture-loisirs;51;44;29;14;2;19;159
mar-08;Economie;68;51;29;27;14;15;204
mar-08;Education;17;12;2;3;4;5;43
mar-08;Environnement;38;21;26;12;7;14;118
mar-08;Faits divers;22;18;13;16;2;9;80
mar-08;Histoire-hommages;14;21;10;7;8;5;65
mar-08;International;95;99;52;61;152;27;486
mar-08;Justice;39;43;35;39;15;29;200
mar-08;Politique France;58;67;68;42;13;37;285
mar-08;Sante;24;19;16;13;7;20;99
mar-08;Sciences et techniques;33;13;8;4;6;3;67
mar-08;Societe;134;98;45;61;42;43;423
mar-08;Sport;69;72;35;20;6;33;235
apr-08;Catastrophes;19;18;12;5;2;10;66
apr-08;Culture-loisirs;57;55;42;19;2;31;206
apr-08;Economie;98;83;42;38;46;29;336
apr-08;Education;27;28;20;19;7;16;117
apr-08;Environnement;26;34;13;1;4;10;88
apr-08;Faits divers;47;41;38;29;12;36;203
apr-08;Histoire-hommages;31;28;26;12;7;8;112
apr-08;International;87;98;65;80;178;23;531
apr-08;Justice;37;41;34;28;11;23;174
apr-08;Politique France;41;37;34;25;22;10;169
apr-08;Sante;32;31;12;11;6;19;111
apr-08;Sciences et techniques;31;19;4;6;2;10;72
apr-08;Societe;147;148;79;57;50;51;532
apr-08;Sport;115;115;54;51;26;55;416
may-08;Catastrophes;85;84;53;36;44;29;331
may-08;Culture-loisirs;53;59;41;18;2;27;200
may-08;Economie;79;75;46;30;34;15;279
may-08;Education;19;18;8;4;5;7;61
may-08;Environnement;22;23;8;3;5;2;63
may-08;Faits divers;24;19;18;13;0;24;98
may-08;Histoire-hommages;23;21;11;8;11;12;86
may-08;International;58;56;31;48;130;17;340
may-08;Justice;29;24;26;25;11;15;130
may-08;Politique France;35;39;25;16;9;9;133
may-08;Sante;15;16;9;4;2;5;51
may-08;Sciences et techniques;18;5;7;3;1;1;35
may-08;Societe;147;119;75;51;32;40;464
may-08;Sport;69;56;28;22;6;34;215
jun-08;Catastrophes;56;45;20;19;17;19;176
jun-08;Culture-loisirs;40;69;32;16;8;21;186
jun-08;Economie;79;62;50;25;23;18;257
jun-08;Education;19;23;16;7;5;12;82
jun-08;Environnement;34;20;5;4;13;1;77
jun-08;Faits divers;20;39;19;17;5;21;121
jun-08;Histoire-hommages;13;7;4;6;3;1;34
jun-08;International;64;96;61;69;150;17;457
jun-08;Justice;32;23;25;17;9;19;125
jun-08;Politique France;25;29;23;11;6;5;99
jun-08;Sante;24;15;18;7;1;6;71
jun-08;Sciences et techniques;8;10;9;5;4;5;41
jun-08;Societe;131;97;68;53;43;45;437
jun-08;Sport;99;91;45;26;7;57;325
jul-08;Catastrophes;28;31;13;15;2;15;104
jul-08;Culture-loisirs;81;75;43;16;6;25;246
jul-08;Economie;65;63;34;17;31;23;233
jul-08;Education;16;11;2;5;2;6;42
jul-08;Environnement;43;30;20;9;5;11;118
jul-08;Faits divers;51;59;35;33;3;44;225
jul-08;Histoire-hommages;11;6;3;5;2;2;29
jul-08;International;99;111;74;84;203;37;608
jul-08;Justice;32;28;30;24;19;16;149
jul-08;Politique France;70;80;54;29;20;27;280
jul-08;Sante;24;22;8;11;0;7;72
jul-08;Sciences et techniques;32;23;17;12;11;18;113
jul-08;Societe;134;99;77;52;53;63;478
jul-08;Sport;104;113;70;54;12;44;397
aug-08;Catastrophes;48;50;24;15;11;22;170
aug-08;Culture-loisirs;38;51;20;11;1;20;141
aug-08;Economie;43;40;28;18;14;12;155
aug-08;Education;19;7;4;4;0;2;36
aug-08;Environnement;20;17;14;6;6;5;68
aug-08;Faits divers;27;18;12;11;2;18;88
aug-08;Histoire-hommages;8;13;11;6;7;4;49
aug-08;International;115;119;92;74;151;45;596
aug-08;Justice;18;24;20;13;17;12;104
aug-08;Politique France;14;16;11;4;3;10;58
aug-08;Sante;19;17;9;7;2;8;62
aug-08;Sciences et techniques;9;12;5;11;3;6;46
aug-08;Societe;92;76;63;37;39;41;348
aug-08;Sport;128;149;88;56;17;63;501
sep-08;Catastrophes;49;49;33;20;21;27;199
sep-08;Culture-loisirs;55;72;50;20;5;28;230
sep-08;Economie;122;127;76;62;65;45;497
sep-08;Education;40;26;10;12;3;19;110
sep-08;Environnement;32;29;17;7;3;9;97
sep-08;Faits divers;51;57;38;20;6;31;203
sep-08;Histoire-hommages;9;14;2;4;6;4;39
sep-08;International;75;107;64;79;158;35;518
sep-08;Justice;26;25;16;22;6;14;109
sep-08;Politique France;43;60;47;25;12;16;203
sep-08;Sante;42;35;14;11;5;20;127
sep-08;Sciences et techniques;18;13;7;6;10;6;60
sep-08;Societe;125;112;75;69;38;50;469
sep-08;Sport;63;59;23;16;1;32;194
oct-08;Catastrophes;7;5;4;6;5;3;30
oct-08;Culture-loisirs;51;65;33;18;4;25;196
oct-08;Economie;128;154;97;85;76;66;606
oct-08;Education;14;6;6;5;4;6;41
oct-08;Environnement;27;19;4;1;8;5;64
oct-08;Faits divers;22;15;11;15;1;12;76
oct-08;Histoire-hommages;25;20;14;10;7;10;86
oct-08;International;55;72;34;69;109;12;351
oct-08;Justice;49;49;37;36;20;34;225
oct-08;Politique France;19;27;18;5;4;6;79
oct-08;Sante;29;31;15;9;2;13;99
oct-08;Sciences et techniques;11;4;4;1;3;6;29
oct-08;Societe;115;97;63;53;30;59;417
oct-08;Sport;47;45;22;13;1;23;151
nov-08;Catastrophes;27;28;13;6;5;10;89
nov-08;Culture-loisirs;55;50;38;24;2;27;196
nov-08;Economie;79;66;46;45;51;28;315
nov-08;Education;12;8;6;2;4;4;36
nov-08;Environnement;20;21;9;5;3;9;67
nov-08;Faits divers;42;35;26;34;8;25;170
nov-08;Histoire-hommages;8;11;6;3;6;5;39
nov-08;International;102;139;61;69;130;35;536
nov-08;Justice;26;28;24;29;18;19;144
nov-08;Politique France;41;57;43;38;14;23;216
nov-08;Sante;21;15;7;7;2;8;60
nov-08;Sciences et techniques;11;11;9;6;6;10;53
nov-08;Societe;133;111;63;74;38;64;483
nov-08;Sport;56;45;20;19;0;27;167
dec-08;Catastrophes;43;40;14;9;2;13;121
dec-08;Culture-loisirs;83;75;53;27;7;39;284
dec-08;Economie;91;104;59;47;47;26;374
dec-08;Education;19;14;19;7;1;9;69
dec-08;Environnement;62;55;27;14;10;10;178
dec-08;Faits divers;48;46;39;36;10;43;222
dec-08;Histoire-hommages;5;3;3;4;5;4;24
dec-08;International;88;104;74;88;165;29;548
dec-08;Justice;38;52;29;52;22;26;219
dec-08;Politique France;20;34;23;19;7;14;117
dec-08;Sante;42;43;16;15;10;21;147
dec-08;Sciences et techniques;8;8;8;3;4;2;33
dec-08;Societe;172;137;100;80;55;75;619
dec-08;Sport;51;54;37;20;0;36;198
jan-09;Catastrophes;70;66;41;18;5;33;233
jan-09;Culture-loisirs;47;48;37;18;2;25;177
jan-09;Economie;52;44;30;41;42;19;228
jan-09;Education;19;12;12;8;5;13;69
jan-09;Environnement;22;20;13;15;2;14;86
jan-09;Faits divers;29;26;17;28;5;24;129
jan-09;Histoire-hommages;10;7;4;4;5;1;31
jan-09;International;93;135;92;93;150;56;619
jan-09;Justice;21;19;16;22;8;11;97
jan-09;Politique France;26;22;17;11;6;12;94
jan-09;Sante;27;30;14;13;5;15;104
jan-09;Sciences et techniques;11;2;8;0;2;3;26
jan-09;Societe;110;97;67;70;34;38;416
jan-09;Sport;40;51;21;17;0;24;153
feb-09;Catastrophes;49;33;21;16;7;15;141
feb-09;Culture-loisirs;47;40;31;21;5;29;173
feb-09;Economie;99;83;51;62;49;38;382
feb-09;Education;16;19;9;12;5;5;66
feb-09;Environnement;15;25;7;12;2;6;67
feb-09;Faits divers;26;33;18;26;2;20;125
feb-09;Histoire-hommages;7;4;4;3;10;1;29
feb-09;International;46;52;40;54;127;23;342
feb-09;Justice;44;45;44;54;13;36;236
feb-09;Politique France;15;25;14;12;5;9;80
feb-09;Sante;17;15;7;4;2;12;57
feb-09;Sciences et techniques;15;6;7;4;1;8;41
feb-09;Societe;133;126;94;66;56;69;544
feb-09;Sport;51;48;32;16;0;28;175
mar-09;Catastrophes;23;17;12;12;1;19;84
mar-09;Culture-loisirs;67;65;50;29;5;33;249
mar-09;Economie;101;116;93;76;53;40;479
mar-09;Education;27;15;15;7;8;10;82
mar-09;Environnement;40;19;12;6;10;9;96
mar-09;Faits divers;37;33;27;23;11;27;158
mar-09;Histoire-hommages;9;14;7;4;6;5;45
mar-09;International;66;89;51;81;153;25;465
mar-09;Justice;41;57;45;56;36;30;265
mar-09;Politique France;25;33;23;10;6;13;110
mar-09;Sante;34;38;14;8;4;16;114
mar-09;Sciences et techniques;22;14;10;11;8;10;75
mar-09;Societe;174;146;113;86;47;93;659
mar-09;Sport;64;56;21;9;1;28;179
apr-09;Catastrophes;35;32;23;17;10;20;137
apr-09;Culture-loisirs;48;53;36;21;6;26;190
apr-09;Economie;52;49;44;23;38;33;239
apr-09;Education;11;11;8;4;2;6;42
apr-09;Environnement;11;7;3;0;6;4;31
apr-09;Faits divers;21;28;24;15;5;21;114
apr-09;Histoire-hommages;8;9;7;8;5;4;41
apr-09;International;72;93;69;66;142;41;483
apr-09;Justice;27;27;26;30;6;19;135
apr-09;Politique France;19;22;18;12;4;12;87
apr-09;Sante;65;66;31;21;13;18;214
apr-09;Sciences et techniques;15;7;6;6;3;2;39
apr-09;Societe;116;108;81;54;29;71;459
apr-09;Sport;37;37;25;15;1;20;135
may-09;Catastrophes;14;16;14;7;5;8;64
may-09;Culture-loisirs;61;68;47;24;3;34;237
may-09;Economie;53;53;30;25;36;20;217
may-09;Education;31;28;16;20;1;15;111
may-09;Environnement;32;21;7;6;1;6;73
may-09;Faits divers;40;37;33;22;3;28;163
may-09;Histoire-hommages;13;12;7;7;11;6;56
may-09;International;71;72;74;56;142;17;432
may-09;Justice;26;41;29;17;11;20;144
may-09;Politique France;10;22;11;4;3;3;53
may-09;Sante;43;51;34;11;12;21;172
may-09;Sciences et techniques;18;15;8;7;1;10;59
may-09;Societe;128;121;75;63;50;63;500
may-09;Sport;43;52;26;15;1;31;168
jun-09;Catastrophes;128;131;71;58;22;42;452
jun-09;Culture-loisirs;56;48;35;16;3;25;183
jun-09;Economie;54;45;29;19;48;20;215
jun-09;Education;19;14;10;5;4;12;64
jun-09;Environnement;11;14;8;2;7;7;49
jun-09;Faits divers;20;15;15;17;6;16;89
jun-09;Histoire-hommages;65;64;28;22;12;22;213
jun-09;International;79;120;96;74;197;25;591
jun-09;Justice;36;33;33;27;15;31;175
jun-09;Politique France;45;53;39;18;8;10;173
jun-09;Sante;58;38;23;8;5;15;147
jun-09;Sciences et techniques;9;5;2;2;2;5;25
jun-09;Societe;103;73;63;41;31;56;367
jun-09;Sport;72;62;34;14;0;46;228
jul-09;Catastrophes;56;57;42;26;6;23;210
jul-09;Culture-loisirs;63;56;32;20;8;23;202
jul-09;Economie;47;47;30;17;26;22;189
jul-09;Education;7;8;8;2;0;6;31
jul-09;Environnement;33;21;13;14;9;9;99
jul-09;Faits divers;35;36;18;18;1;24;132
jul-09;Histoire-hommages;52;35;8;14;9;11;129
jul-09;International;29;47;41;49;146;10;322
jul-09;Justice;15;20;24;25;12;10;106
jul-09;Politique France;36;38;34;22;10;19;159
jul-09;Sante;33;38;23;12;6;18;130
jul-09;Sciences et techniques;27;25;16;9;10;11;98
jul-09;Societe;91;82;60;58;38;39;368
jul-09;Sport;66;67;37;34;0;40;244
aug-09;Catastrophes;33;48;28;19;10;21;159
aug-09;Culture-loisirs;62;33;29;12;1;27;164
aug-09;Economie;80;67;47;33;26;19;272
aug-09;Education;14;7;8;3;2;5;39
aug-09;Environnement;43;30;16;9;6;10;114
aug-09;Faits divers;40;40;39;34;9;40;202
aug-09;Histoire-hommages;19;19;8;10;13;6;75
aug-09;International;51;75;56;56;131;25;394
aug-09;Justice;18;16;10;21;16;7;88
aug-09;Politique France;26;27;24;14;6;12;109
aug-09;Sante;36;33;34;22;11;23;159
aug-09;Sciences et techniques;7;8;5;2;3;2;27
aug-09;Societe;87;92;44;40;26;49;338
aug-09;Sport;58;49;24;17;0;25;173
sep-09;Catastrophes;57;41;28;13;8;18;165
sep-09;Culture-loisirs;74;70;42;17;2;41;246
sep-09;Economie;80;69;54;47;37;34;321
sep-09;Education;28;22;6;10;3;17;86
sep-09;Environnement;35;27;23;14;9;15;123
sep-09;Faits divers;30;39;28;26;3;22;148
sep-09;Histoire-hommages;11;21;6;9;12;14;73
sep-09;International;57;88;55;60;186;43;489
sep-09;Justice;50;45;44;38;17;44;238
sep-09;Politique France;54;51;44;32;16;32;229
sep-09;Sante;59;58;48;25;7;35;232
sep-09;Sciences et techniques;22;10;6;1;6;5;50
sep-09;Societe;88;108;62;66;29;72;425
sep-09;Sport;70;55;20;25;4;58;232
oct-09;Catastrophes;34;30;19;11;5;14;113
oct-09;Culture-loisirs;53;51;38;11;3;19;175
oct-09;Economie;55;50;25;30;24;24;208
oct-09;Education;10;15;8;5;3;10;51
oct-09;Environnement;26;18;14;10;11;4;83
oct-09;Faits divers;19;18;12;18;0;18;85
oct-09;Histoire-hommages;4;6;3;3;7;3;26
oct-09;International;44;63;50;46;145;42;390
oct-09;Justice;67;54;50;62;20;65;318
oct-09;Politique France;36;54;28;21;14;41;194
oct-09;Sante;45;24;20;17;11;18;135
oct-09;Sciences et techniques;16;12;12;5;11;10;66
oct-09;Societe;103;79;75;61;30;86;434
oct-09;Sport;61;42;25;15;0;50;193
nov-09;Catastrophes;34;21;14;4;5;13;91
nov-09;Culture-loisirs;51;45;32;11;4;16;159
nov-09;Economie;45;35;23;13;17;32;165
nov-09;Education;6;4;7;3;1;0;21
nov-09;Environnement;27;22;9;8;9;9;84
nov-09;Faits divers;43;43;22;20;2;46;176
nov-09;Histoire-hommages;26;32;39;10;31;17;155
nov-09;International;29;45;37;48;111;36;306
nov-09;Justice;38;36;38;26;24;42;204
nov-09;Politique France;27;34;32;19;10;18;140
nov-09;Sante;58;63;37;24;8;33;223
nov-09;Sciences et techniques;13;11;3;1;6;2;36
nov-09;Societe;105;88;50;50;40;81;414
nov-09;Sport;75;56;25;30;5;76;267
dec-09;Catastrophes;63;45;30;13;3;29;183
dec-09;Culture-loisirs;61;65;43;9;4;26;208
dec-09;Economie;62;46;28;17;36;26;215
dec-09;Education;6;4;5;2;4;2;23
dec-09;Environnement;63;53;58;27;32;29;262
dec-09;Faits divers;50;53;41;23;5;55;227
dec-09;Histoire-hommages;5;10;7;5;11;3;41
dec-09;International;52;72;51;60;150;40;425
dec-09;Justice;53;26;25;17;20;39;180
dec-09;Politique France;23;27;11;4;5;22;92
dec-09;Sante;54;57;35;21;9;45;221
dec-09;Sciences et techniques;6;10;3;3;3;3;28
dec-09;Societe;159;166;101;76;49;122;673
dec-09;Sport;43;43;16;16;0;56;174
jan-10;Catastrophes;162;129;93;54;40;94;572
jan-10;Culture-loisirs;50;38;31;8;60;23;210
jan-10;Economie;37;28;21;19;26;33;164
jan-10;Education;18;12;14;7;0;9;60
jan-10;Environnement;36;24;16;6;5;16;103
jan-10;Faits divers;22;18;19;7;0;28;94
jan-10;Histoire-hommages;10;21;18;10;6;9;74
jan-10;International;42;54;36;50;96;36;314
jan-10;Justice;28;20;8;13;15;15;99
jan-10;Politique France;37;29;31;17;6;19;139
jan-10;Sante;20;16;20;6;8;16;86
jan-10;Sciences et techniques;9;4;2;4;3;4;26
jan-10;Societe;104;96;64;62;45;73;444
jan-10;Sport;48;37;12;2;1;37;137
feb-10;Catastrophes;65;52;37;26;11;35;226
feb-10;Culture-loisirs;56;42;25;18;96;21;258
feb-10;Economie;47;39;21;27;32;26;192
feb-10;Education;25;15;17;15;4;15;91
feb-10;Environnement;34;20;13;4;3;13;87
feb-10;Faits divers;28;16;21;12;8;27;112
feb-10;Histoire-hommages;13;4;8;8;7;6;46
feb-10;International;34;47;36;44;81;31;273
feb-10;Justice;29;24;31;10;10;27;131
feb-10;Politique France;38;43;31;14;6;20;152
feb-10;Sante;14;11;9;7;3;11;55
feb-10;Sciences et techniques;11;12;3;5;4;7;42
feb-10;Societe;111;134;73;70;49;83;520
feb-10;Sport;60;69;26;12;4;61;232
mar-10;Catastrophes;134;98;78;42;11;69;432
mar-10;Culture-loisirs;50;47;29;13;90;27;256
mar-10;Economie;48;50;31;25;56;24;234
mar-10;Education;14;12;8;5;3;12;54
mar-10;Environnement;33;25;22;10;9;18;117
mar-10;Faits divers;30;29;20;24;8;37;148
mar-10;Histoire-hommages;15;15;7;4;6;5;52
mar-10;International;37;49;43;43;123;30;325
mar-10;Justice;39;38;31;28;17;34;187
mar-10;Politique France;75;98;75;32;20;69;369
mar-10;Sante;22;23;13;8;3;21;90
mar-10;Sciences et techniques;10;6;5;6;5;6;38
mar-10;Societe;126;88;77;65;51;86;493
mar-10;Sport;46;65;24;19;0;60;214
apr-10;Catastrophes;87;68;46;21;20;50;292
apr-10;Culture-loisirs;51;39;22;6;74;27;219
apr-10;Economie;41;42;26;18;21;34;182
apr-10;Education;16;10;6;3;4;12;51
apr-10;Environnement;29;28;21;11;5;13;107
apr-10;Faits divers;26;18;22;16;0;35;117
apr-10;Histoire-hommages;12;18;13;8;13;13;77
apr-10;International;33;50;38;40;112;20;293
apr-10;Justice;31;21;23;26;11;30;142
apr-10;Politique France;15;12;4;5;2;7;45
apr-10;Sante;15;18;18;4;0;12;67
apr-10;Sciences et techniques;9;4;3;0;4;7;27
apr-10;Societe;184;174;125;78;56;129;746
apr-10;Sport;39;33;16;14;0;44;146
may-10;Catastrophes;30;23;17;13;14;19;116
may-10;Culture-loisirs;53;49;37;11;79;37;266
may-10;Economie;49;79;34;29;37;52;280
may-10;Education;11;12;9;3;0;10;45
may-10;Environnement;74;47;39;23;23;40;246
may-10;Faits divers;39;27;21;19;1;33;140
may-10;Histoire-hommages;9;8;6;0;7;3;33
may-10;International;52;87;51;54;92;39;375
may-10;Justice;26;37;22;21;5;32;143
may-10;Politique France;15;14;9;3;2;16;59
may-10;Sante;21;17;13;5;6;11;73
may-10;Sciences et techniques;11;2;3;3;3;3;25
may-10;Societe;123;95;76;53;38;60;445
may-10;Sport;64;66;31;18;0;56;235
jun-10;Catastrophes;64;45;33;28;8;41;219
jun-10;Culture-loisirs;35;32;31;11;86;23;218
jun-10;Economie;36;38;36;16;20;29;175
jun-10;Education;19;16;10;6;5;11;67
jun-10;Environnement;40;20;12;9;21;20;122
jun-10;Faits divers;37;28;19;20;3;40;147
jun-10;Histoire-hommages;17;18;15;10;7;14;81
jun-10;International;58;68;65;53;150;36;430
jun-10;Justice;25;38;39;30;17;39;188
jun-10;Politique France;33;52;33;19;8;22;167
jun-10;Sante;17;11;9;8;4;10;59
jun-10;Sciences et techniques;6;6;5;6;2;6;31
jun-10;Societe;100;86;79;42;28;70;405
jun-10;Sport;178;160;93;76;17;127;651
jul-10;Catastrophes;38;28;20;18;9;31;144
jul-10;Culture-loisirs;59;51;40;14;90;28;282
jul-10;Economie;31;23;14;11;17;19;115
jul-10;Education;5;5;3;3;2;8;26
jul-10;Environnement;43;29;20;11;16;23;142
jul-10;Faits divers;32;28;22;14;7;26;129
jul-10;Histoire-hommages;10;20;10;4;3;10;57
jul-10;International;29;64;55;35;87;27;297
jul-10;Justice;25;40;20;36;10;44;175
jul-10;Politique France;65;64;51;36;17;36;269
jul-10;Sante;26;26;14;11;2;21;100
jul-10;Sciences et techniques;12;4;3;4;2;7;32
jul-10;Societe;83;87;65;52;32;86;405
jul-10;Sport;74;85;61;44;5;69;338
aug-10;Catastrophes;75;88;69;61;55;58;406
aug-10;Culture-loisirs;65;51;41;11;84;32;284
aug-10;Economie;67;66;32;26;19;36;246
aug-10;Education;24;20;17;5;1;19;86
aug-10;Environnement;50;29;14;10;19;20;142
aug-10;Faits divers;37;28;23;15;3;35;141
aug-10;Histoire-hommages;13;6;3;4;8;4;38
aug-10;International;37;71;57;35;99;37;336
aug-10;Justice;22;27;25;15;4;28;121
aug-10;Politique France;59;73;46;51;18;46;293
aug-10;Sante;16;13;16;6;3;12;66
aug-10;Sciences et techniques;12;9;8;4;2;8;43
aug-10;Societe;138;105;80;60;28;82;493
aug-10;Sport;80;73;55;41;0;64;313
sep-10;Catastrophes;25;24;15;10;9;20;103
sep-10;Culture-loisirs;60;45;40;9;74;37;265
sep-10;Economie;45;32;29;20;13;19;158
sep-10;Education;19;11;8;3;1;9;51
sep-10;Environnement;19;14;5;7;2;4;51
sep-10;Faits divers;19;19;20;9;3;27;97
sep-10;Histoire-hommages;17;12;13;7;13;13;75
sep-10;International;70;98;81;58;115;43;465
sep-10;Justice;24;27;29;24;4;29;137
sep-10;Politique France;40;45;26;23;11;28;173
sep-10;Sante;24;24;17;5;1;17;88
sep-10;Sciences et techniques;12;9;4;4;7;3;39
sep-10;Societe;123;114;106;80;51;90;564
sep-10;Sport;43;35;20;10;0;40;148
oct-10;Catastrophes;31;27;14;15;12;28;127
oct-10;Culture-loisirs;52;43;35;10;86;42;268
oct-10;Economie;32;32;18;12;16;14;124
oct-10;Education;9;5;2;2;0;1;19
oct-10;Environnement;28;16;18;8;12;14;96
oct-10;Faits divers;22;16;26;13;0;25;102
oct-10;Histoire-hommages;10;9;6;3;7;3;38
oct-10;International;28;61;44;36;94;16;279
oct-10;Justice;24;24;34;24;8;27;141
oct-10;Politique France;12;11;9;4;5;6;47
oct-10;Sante;19;24;15;10;4;16;88
oct-10;Sciences et techniques;12;9;6;1;4;13;45
oct-10;Societe;229;261;186;117;67;137;997
oct-10;Sport;37;32;18;6;0;18;111
nov-10;Catastrophes;61;67;50;20;6;41;245
nov-10;Culture-loisirs;65;46;29;14;88;48;290
nov-10;Economie;57;44;45;24;36;23;229
nov-10;Education;16;17;13;5;3;10;64
nov-10;Environnement;60;45;43;16;6;13;183
nov-10;Faits divers;43;38;36;20;7;42;186
nov-10;Histoire-hommages;15;7;6;6;8;8;50
nov-10;International;72;101;93;56;117;49;488
nov-10;Justice;35;32;35;25;13;31;171
nov-10;Politique France;66;88;58;28;14;29;283
nov-10;Sante;30;32;31;10;11;18;132
nov-10;Sciences et techniques;19;15;8;7;15;11;75
nov-10;Societe;122;156;96;74;49;120;617
nov-10;Sport;58;55;36;11;1;42;203
dec-10;Catastrophes;134;109;98;37;8;59;445
dec-10;Culture-loisirs;70;36;22;8;65;39;240
dec-10;Economie;35;35;26;14;19;24;153
dec-10;Education;6;10;4;4;4;6;34
dec-10;Environnement;26;27;21;12;7;26;119
dec-10;Faits divers;22;16;20;18;0;24;100
dec-10;Histoire-hommages;5;8;2;6;6;4;31
dec-10;International;56;102;94;48;110;46;456
dec-10;Justice;24;37;30;25;18;26;160
dec-10;Politique France;27;31;32;7;4;8;109
dec-10;Sante;17;22;22;5;2;14;82
dec-10;Sciences et techniques;6;5;3;3;0;5;22
dec-10;Societe;115;98;73;47;33;63;429
dec-10;Sport;23;20;9;6;1;15;74
jan-11;Catastrophes;41;32;28;21;8;25;155
jan-11;Culture-loisirs;60;41;37;5;75;56;274
jan-11;Economie;50;27;24;18;20;16;155
jan-11;Education;13;12;8;4;1;11;49
jan-11;Environnement;14;8;9;3;1;7;42
jan-11;Faits divers;38;43;37;16;4;44;182
jan-11;Histoire-hommages;13;8;6;1;5;3;36
jan-11;International;145;201;133;82;153;99;813
jan-11;Justice;24;28;23;20;3;18;116
jan-11;Politique France;29;46;31;9;4;16;135
jan-11;Sante;33;27;22;13;5;28;128
jan-11;Sciences et techniques;6;6;9;2;1;3;27
jan-11;Societe;89;83;55;38;23;66;354
jan-11;Sport;36;39;16;2;1;13;107
feb-11;Catastrophes;25;18;19;13;2;10;87
feb-11;Culture-loisirs;50;37;20;5;73;42;227
feb-11;Economie;49;44;36;14;5;18;166
feb-11;Education;9;8;12;5;0;7;41
feb-11;Environnement;18;11;7;1;0;11;48
feb-11;Faits divers;48;43;45;18;1;56;211
feb-11;Histoire-hommages;8;9;3;2;9;2;33
feb-11;International;160;225;142;110;187;86;910
feb-11;Justice;40;43;38;35;8;37;201
feb-11;Politique France;30;42;21;24;4;16;137
feb-11;Sante;25;19;12;8;4;20;88
feb-11;Sciences et techniques;11;5;8;5;3;9;41
feb-11;Societe;78;52;50;33;22;65;300
feb-11;Sport;43;52;25;12;0;31;163
mar-11;Catastrophes;94;83;58;44;16;77;372
mar-11;Culture-loisirs;59;45;22;4;79;50;259
mar-11;Economie;62;37;29;21;7;39;195
mar-11;Education;9;11;5;3;1;9;38
mar-11;Environnement;120;121;69;28;48;80;466
mar-11;Faits divers;30;36;30;14;1;41;152
mar-11;Histoire-hommages;15;12;10;3;4;7;51
mar-11;International;179;218;142;105;193;97;934
mar-11;Justice;19;24;22;19;9;27;120
mar-11;Politique France;77;123;83;29;8;47;367
mar-11;Sante;31;11;21;9;0;18;90
mar-11;Sciences et techniques;7;13;7;2;7;9;45
mar-11;Societe;70;51;49;44;14;52;280
mar-11;Sport;41;42;15;5;0;17;120
apr-11;Catastrophes;22;20;15;12;5;16;90
apr-11;Culture-loisirs;56;40;24;7;55;46;228
apr-11;Economie;49;48;32;21;13;29;192
apr-11;Education;10;5;8;1;1;1;26
apr-11;Environnement;56;30;31;7;19;21;164
apr-11;Faits divers;58;48;44;19;1;48;218
apr-11;Histoire-hommages;6;5;3;1;6;3;24
apr-11;International;115;184;114;91;163;64;731
apr-11;Justice;18;22;21;16;8;22;107
apr-11;Politique France;22;43;34;15;3;16;133
apr-11;Sante;18;19;25;7;1;22;92
apr-11;Sciences et techniques;12;10;11;6;12;6;57
apr-11;Societe;122;101;75;37;28;95;458
apr-11;Sport;37;32;16;2;1;10;98
may-11;Catastrophes;44;33;22;21;4;17;141
may-11;Culture-loisirs;57;52;33;5;92;50;289
may-11;Economie;44;27;26;15;16;21;149
may-11;Education;20;18;11;3;3;10;65
may-11;Environnement;48;44;27;15;21;31;186
may-11;Faits divers;27;20;25;8;1;35;116
may-11;Histoire-hommages;16;15;15;5;10;10;71
may-11;International;120;157;128;86;172;94;757
may-11;Justice;131;130;81;51;25;78;496
may-11;Politique France;64;71;48;29;4;44;260
may-11;Sante;36;44;36;15;7;35;173
may-11;Sciences et techniques;11;6;6;2;0;8;33
may-11;Societe;114;87;61;32;38;99;431
may-11;Sport;59;72;41;13;8;41;234
jun-11;Catastrophes;22;26;28;12;0;23;111
jun-11;Culture-loisirs;43;30;20;5;70;42;210
jun-11;Economie;53;51;42;16;26;28;216
jun-11;Education;39;29;18;15;0;21;122
jun-11;Environnement;38;24;12;7;11;16;108
jun-11;Faits divers;43;37;30;18;0;37;165
jun-11;Histoire-hommages;15;10;2;0;8;4;39
jun-11;International;74;118;77;62;124;44;499
jun-11;Justice;62;65;45;40;11;55;278
jun-11;Politique France;50;74;48;24;5;37;238
jun-11;Sante;48;38;31;11;7;42;177
jun-11;Sciences et techniques;10;9;6;4;4;6;39
jun-11;Societe;90;88;53;53;29;60;373
jun-11;Sport;47;39;22;4;3;26;141
jul-11;Catastrophes;32;32;20;15;11;21;131
jul-11;Culture-loisirs;68;39;28;11;27;44;217
jul-11;Economie;67;65;49;30;23;28;262
jul-11;Education;12;14;8;4;0;5;43
jul-11;Environnement;23;29;21;12;5;16;106
jul-11;Faits divers;33;21;18;13;1;35;121
jul-11;Histoire-hommages;16;12;9;7;4;5;53
jul-11;International;75;105;69;80;118;48;495
jul-11;Justice;53;54;29;30;8;33;207
jul-11;Politique France;38;60;43;29;5;26;201
jul-11;Sante;14;11;10;5;0;8;48
jul-11;Sciences et techniques;18;9;9;4;2;14;56
jul-11;Societe;91;84;68;49;22;92;406
jul-11;Sport;67;67;43;30;3;45;255
aug-11;Catastrophes;44;50;36;24;15;27;196
aug-11;Culture-loisirs;77;50;26;7;44;45;249
aug-11;Economie;129;136;79;52;42;63;501
aug-11;Education;16;22;15;6;0;10;69
aug-11;Environnement;48;32;23;6;9;21;139
aug-11;Faits divers;49;54;57;29;1;69;259
aug-11;Histoire-hommages;9;8;5;9;6;2;39
aug-11;International;77;111;68;83;158;37;534
aug-11;Justice;44;46;36;30;9;33;198
aug-11;Politique France;36;28;38;17;2;20;141
aug-11;Sante;18;17;18;14;3;20;90
aug-11;Sciences et techniques;14;6;3;3;0;4;30
aug-11;Societe;137;124;92;79;38;125;595
aug-11;Sport;81;57;41;24;1;31;235
sep-11;Catastrophes;17;19;13;5;1;16;71
sep-11;Culture-loisirs;49;39;27;14;58;46;233
sep-11;Economie;78;92;39;51;41;37;338
sep-11;Education;18;25;15;10;4;21;93
sep-11;Environnement;23;17;5;6;6;11;68
sep-11;Faits divers;28;29;32;10;0;42;141
sep-11;Histoire-hommages;9;13;9;3;4;8;46
sep-11;International;85;81;44;73;142;35;460
sep-11;Justice;61;73;63;59;15;64;335
sep-11;Politique France;49;55;53;34;7;35;233
sep-11;Sante;23;14;22;11;5;9;84
sep-11;Sciences et techniques;13;8;10;9;2;12;54
sep-11;Societe;71;71;43;53;20;56;314
sep-11;Sport;61;53;29;21;0;33;197
oct-11;Catastrophes;26;26;16;15;8;18;109
oct-11;Culture-loisirs;53;31;23;15;62;49;233
oct-11;Economie;63;65;37;40;37;41;283
oct-11;Education;12;12;2;7;0;5;38
oct-11;Environnement;23;13;10;10;3;10;69
oct-11;Faits divers;30;34;21;14;3;37;139
oct-11;Histoire-hommages;11;16;4;7;12;4;54
oct-11;International;69;75;59;85;133;50;471
oct-11;Justice;45;36;41;28;4;39;193
oct-11;Politique France;91;140;74;43;10;50;408
oct-11;Sante;20;10;11;2;3;17;63
oct-11;Sciences et techniques;7;8;7;0;1;3;26
oct-11;Societe;86;74;57;73;33;78;401
oct-11;Sport;75;63;33;18;0;36;225
nov-11;Catastrophes;69;50;47;21;3;45;235
nov-11;Culture-loisirs;58;50;29;10;80;64;291
nov-11;Economie;95;105;71;43;33;58;405
nov-11;Education;17;15;6;5;2;9;54
nov-11;Environnement;32;39;16;11;11;10;119
nov-11;Faits divers;60;51;46;19;14;57;247
nov-11;Histoire-hommages;17;17;16;8;7;12;77
nov-11;International;100;111;83;116;176;65;651
nov-11;Justice;48;42;27;49;11;44;221
nov-11;Politique France;43;66;34;28;4;26;201
nov-11;Sante;22;21;20;11;1;20;95
nov-11;Sciences et techniques;20;18;9;12;8;11;78
nov-11;Societe;121;102;78;71;48;111;531
nov-11;Sport;44;33;16;11;0;24;128
dec-11;Catastrophes;38;26;28;10;2;16;120
dec-11;Culture-loisirs;68;42;33;8;47;42;240
dec-11;Economie;67;73;48;37;18;32;275
dec-11;Education;8;8;4;7;1;2;30
dec-11;Environnement;20;20;16;8;8;11;83
dec-11;Faits divers;35;37;33;17;1;37;160
dec-11;Histoire-hommages;13;17;8;9;11;6;64
dec-11;International;61;114;40;67;133;32;447
dec-11;Justice;37;28;31;34;14;33;177
dec-11;Politique France;26;30;27;22;7;19;131
dec-11;Sante;23;33;18;11;2;22;109
dec-11;Sciences et techniques;12;8;10;7;3;8;48
dec-11;Societe;149;125;90;80;25;122;591
dec-11;Sport;38;27;11;14;1;23;114
jan-12;Catastrophes;111;80;45;18;2;45;301
jan-12;Culture-loisirs;73;59;38;16;33;60;279
jan-12;Economie;99;111;78;64;31;56;439
jan-12;Education;14;16;10;6;2;8;56
jan-12;Environnement;26;50;15;16;5;23;135
jan-12;Faits divers;29;27;33;12;3;49;153
jan-12;Histoire-hommages;12;8;9;4;10;8;51
jan-12;International;72;97;53;93;178;44;537
jan-12;Justice;28;23;28;19;14;25;137
jan-12;Politique France;79;103;82;52;13;46;375
jan-12;Sante;32;29;17;11;3;19;111
jan-12;Sciences et techniques;13;9;6;6;3;7;44
jan-12;Societe;111;105;74;61;38;78;467
jan-12;Sport;47;44;24;7;0;26;148
feb-12;Catastrophes;63;59;40;11;0;50;223
feb-12;Culture-loisirs;50;36;29;17;36;52;220
feb-12;Economie;65;68;52;30;26;35;276
feb-12;Education;9;13;7;2;3;5;39
feb-12;Environnement;57;47;22;7;6;19;158
feb-12;Faits divers;25;19;17;5;5;31;102
feb-12;Histoire-hommages;10;12;6;4;11;14;57
feb-12;International;53;74;40;79;132;36;414
feb-12;Justice;26;23;28;32;7;34;150
feb-12;Politique France;87;107;82;51;7;69;403
feb-12;Sante;22;15;15;10;1;13;76
feb-12;Sciences et techniques;5;9;2;4;1;8;29
feb-12;Societe;106;98;62;66;35;73;440
feb-12;Sport;37;35;17;9;0;18;116
mar-12;Catastrophes;58;52;34;16;2;32;194
mar-12;Culture-loisirs;36;22;17;12;20;34;141
mar-12;Economie;38;27;27;21;20;16;149
mar-12;Education;11;15;6;2;0;7;41
mar-12;Environnement;35;27;23;8;12;11;116
mar-12;Faits divers;25;29;15;18;5;28;120
mar-12;Histoire-hommages;19;20;9;5;8;12;73
mar-12;International;40;51;26;68;110;18;313
mar-12;Justice;26;29;15;17;10;19;116
mar-12;Politique France;195;198;155;89;35;147;819
mar-12;Sante;17;19;13;10;5;21;85
mar-12;Sciences et techniques;8;7;8;3;1;5;32
mar-12;Societe;80;101;40;52;29;53;355
mar-12;Sport;36;41;19;6;0;20;122
apr-12;Catastrophes;21;25;17;15;4;16;98
apr-12;Culture-loisirs;37;36;14;14;18;52;171
apr-12;Economie;68;72;35;28;17;29;249
apr-12;Education;9;7;5;1;0;6;28
apr-12;Environnement;27;25;15;9;4;11;91
apr-12;Faits divers;61;42;48;23;5;38;217
apr-12;Histoire-hommages;13;10;9;4;5;5;46
apr-12;International;59;70;33;63;127;25;377
apr-12;Justice;31;35;25;25;12;22;150
apr-12;Politique France;120;129;109;52;39;142;591
apr-12;Sante;14;18;8;4;1;12;57
apr-12;Sciences et techniques;15;13;7;5;4;11;55
apr-12;Societe;72;85;55;53;31;72;368
apr-12;Sport;28;23;22;16;2;22;113
may-12;Catastrophes;42;37;29;12;3;18;141
may-12;Culture-loisirs;63;33;30;19;38;61;244
may-12;Economie;62;69;49;33;33;33;279
may-12;Education;16;18;6;5;1;6;52
may-12;Environnement;22;20;9;8;7;9;75
may-12;Faits divers;40;29;34;12;2;37;154
may-12;Histoire-hommages;13;18;10;7;3;12;63
may-12;International;103;144;69;107;169;58;650
may-12;Justice;28;28;25;33;15;32;161
may-12;Politique France;174;221;133;62;27;105;722
may-12;Sante;27;15;12;8;2;22;86
may-12;Sciences et techniques;7;10;8;5;2;8;40
may-12;Societe;104;94;61;58;30;104;451
may-12;Sport;80;63;40;20;3;29;235
jun-12;Catastrophes;15;13;10;12;3;15;68
jun-12;Culture-loisirs;47;20;22;12;31;37;169
jun-12;Economie;58;70;40;34;39;16;257
jun-12;Education;26;33;14;7;0;16;96
jun-12;Environnement;19;15;11;7;9;4;65
jun-12;Faits divers;43;47;41;23;0;42;196
jun-12;Histoire-hommages;22;14;9;4;3;15;67
jun-12;International;55;80;37;46;93;27;338
jun-12;Justice;30;13;25;23;15;12;118
jun-12;Politique France;84;109;89;35;21;83;421
jun-12;Sante;11;19;11;3;1;14;59
jun-12;Sciences et techniques;9;9;8;2;2;4;34
jun-12;Societe;78;97;55;42;31;53;356
jun-12;Sport;86;53;29;23;3;73;267
jul-12;Catastrophes;45;62;39;16;7;44;213
jul-12;Culture-loisirs;79;35;32;9;42;63;260
jul-12;Economie;109;127;72;42;38;67;455
jul-12;Education;11;16;7;5;0;9;48
jul-12;Environnement;37;36;17;9;9;14;122
jul-12;Faits divers;39;36;42;13;2;54;186
jul-12;Histoire-hommages;13;22;13;7;14;11;80
jul-12;International;46;96;45;41;129;26;383
jul-12;Justice;20;26;19;18;14;25;122
jul-12;Politique France;55;55;25;17;6;27;185
jul-12;Sante;19;21;12;8;2;12;74
jul-12;Sciences et techniques;20;14;5;6;6;7;58
jul-12;Societe;94;109;77;51;31;85;447
jul-12;Sport;156;172;105;46;10;75;564
aug-12;Catastrophes;36;47;38;16;8;26;171
aug-12;Culture-loisirs;52;26;17;8;22;36;161
aug-12;Economie;62;69;39;34;28;34;266
aug-12;Education;18;14;5;4;1;9;51
aug-12;Environnement;50;27;20;10;9;19;135
aug-12;Faits divers;22;33;19;14;4;24;116
aug-12;Histoire-hommages;10;17;6;7;6;5;51
aug-12;International;44;85;42;57;109;40;377
aug-12;Justice;19;19;20;20;17;17;112
aug-12;Politique France;37;32;37;18;6;29;159
aug-12;Sante;22;31;21;11;2;20;107
aug-12;Sciences et techniques;27;16;12;5;5;12;77
aug-12;Societe;99;82;62;45;30;74;392
aug-12;Sport;108;179;73;29;3;43;435
sep-12;Catastrophes;18;19;18;8;3;16;82
sep-12;Culture-loisirs;55;35;20;15;27;55;207
sep-12;Economie;63;106;68;32;37;43;349
sep-12;Education;26;26;27;11;0;13;103
sep-12;Environnement;15;14;14;10;5;7;65
sep-12;Faits divers;60;47;38;6;2;49;202
sep-12;Histoire-hommages;15;10;8;3;7;4;47
sep-12;International;52;67;36;49;98;32;334
sep-12;Justice;30;32;29;28;10;31;160
sep-12;Politique France;34;39;38;23;5;29;168
sep-12;Sante;14;27;18;9;2;19;89
sep-12;Sciences et techniques;13;7;6;3;1;5;35
sep-12;Societe;120;138;89;68;59;109;583
sep-12;Sport;44;36;14;9;0;27;130
oct-12;Catastrophes;59;70;45;20;5;60;259
oct-12;Culture-loisirs;64;43;31;19;39;58;254
oct-12;Economie;87;119;60;31;37;32;366
oct-12;Education;16;23;15;4;4;8;70
oct-12;Environnement;25;25;24;7;6;14;101
oct-12;Faits divers;41;53;40;25;1;60;220
oct-12;Histoire-hommages;15;10;8;3;5;4;45
oct-12;International;55;83;45;81;147;32;443
oct-12;Justice;57;64;54;58;19;46;298
oct-12;Politique France;49;68;50;24;11;35;237
oct-12;Sante;31;26;22;9;4;22;114
oct-12;Sciences et techniques;15;12;8;2;2;9;48
oct-12;Societe;133;139;87;72;43;119;593
oct-12;Sport;61;35;23;17;1;29;166
nov-12;Catastrophes;17;28;15;4;3;19;86
nov-12;Culture-loisirs;46;27;24;5;26;47;175
nov-12;Economie;69;94;49;27;23;29;291
nov-12;Education;5;5;5;5;0;3;23
nov-12;Environnement;23;27;18;9;9;11;97
nov-12;Faits divers;38;44;41;13;2;52;190
nov-12;Histoire-hommages;11;13;7;7;5;7;50
nov-12;International;97;115;54;81;118;56;521
nov-12;Justice;27;32;27;22;10;28;146
nov-12;Politique France;56;96;63;32;13;45;305
nov-12;Sante;11;22;17;10;2;13;75
nov-12;Sciences et techniques;8;5;4;6;0;5;28
nov-12;Societe;111;136;72;69;35;92;515
nov-12;Sport;46;32;27;12;0;26;143
dec-12;Catastrophes;27;36;19;12;4;18;116
dec-12;Culture-loisirs;63;50;37;5;23;51;229
dec-12;Economie;64;93;52;39;19;41;308
dec-12;Education;8;14;10;7;1;9;49
dec-12;Environnement;23;25;18;9;14;12;101
dec-12;Faits divers;49;48;36;13;7;53;206
dec-12;Histoire-hommages;7;6;4;3;7;5;32
dec-12;International;45;83;50;49;119;34;380
dec-12;Justice;21;25;23;22;14;20;125
dec-12;Politique France;31;43;22;19;3;18;136
dec-12;Sante;35;25;26;9;2;20;117
dec-12;Sciences et techniques;13;12;6;7;1;9;48
dec-12;Societe;132;171;101;73;45;116;638
dec-12;Sport;33;17;7;16;0;9;82
jan-13;Catastrophes;52;76;25;12;2;48;215
jan-13;Culture-loisirs;76;67;24;12;23;58;260
jan-13;Economie;68;86;61;45;34;42;336
jan-13;Education;13;9;10;3;3;13;51
jan-13;Environnement;28;30;36;9;5;14;122
jan-13;Faits divers;32;42;30;13;8;54;179
jan-13;Histoire-hommages;10;10;4;7;15;5;51
jan-13;International;143;174;96;75;139;82;709
jan-13;Justice;28;44;33;28;14;46;193
jan-13;Politique France;35;33;23;10;5;19;125
jan-13;Sante;17;29;20;13;5;20;104
jan-13;Sciences et techniques;9;11;8;7;3;8;46
jan-13;Societe;154;166;107;81;56;110;674
jan-13;Sport;56;40;27;18;3;31;175
feb-13;Catastrophes;30;31;22;9;0;16;108
feb-13;Culture-loisirs;40;46;26;15;34;41;202
feb-13;Economie;64;70;49;38;26;46;293
feb-13;Education;16;12;13;3;3;21;68
feb-13;Environnement;27;22;12;9;4;5;79
feb-13;Faits divers;32;33;25;21;3;52;166
feb-13;Histoire-hommages;9;9;3;4;6;2;33
feb-13;International;96;111;57;66;119;63;512
feb-13;Justice;16;11;17;19;8;24;95
feb-13;Politique France;16;29;13;8;1;15;82
feb-13;Sante;18;21;16;5;3;14;77
feb-13;Sciences et techniques;14;11;3;11;2;11;52
feb-13;Societe;139;193;118;77;50;128;705
feb-13;Sport;43;34;25;17;1;23;143
mar-13;Catastrophes;42;60;40;9;0;37;188
mar-13;Culture-loisirs;35;24;23;14;21;51;168
mar-13;Economie;51;81;43;35;34;33;277
mar-13;Education;9;9;9;3;0;8;38
mar-13;Environnement;25;27;13;10;10;15;100
mar-13;Faits divers;22;31;14;10;5;17;99
mar-13;Histoire-hommages;13;21;12;10;10;9;75
mar-13;International;45;75;30;77;105;31;363
mar-13;Justice;32;38;35;19;13;44;181
mar-13;Politique France;42;48;39;20;3;34;186
mar-13;Sante;12;15;15;15;2;17;76
mar-13;Sciences et techniques;16;8;7;4;1;8;44
mar-13;Societe;164;156;96;78;50;114;658
mar-13;Sport;38;25;11;14;0;14;102
apr-13;Catastrophes;27;31;24;14;5;21;122
apr-13;Culture-loisirs;79;35;24;13;29;48;228
apr-13;Economie;91;82;48;44;32;38;335
apr-13;Education;14;18;13;3;0;8;56
apr-13;Environnement;37;38;22;10;6;11;124
apr-13;Faits divers;46;52;46;32;3;56;235
apr-13;Histoire-hommages;13;11;9;10;7;6;56
apr-13;International;88;128;59;95;134;75;579
apr-13;Justice;29;34;37;32;20;36;188
apr-13;Politique France;96;127;77;42;18;66;426
apr-13;Sante;29;25;24;15;8;18;119
apr-13;Sciences et techniques;10;13;9;6;3;8;49
apr-13;Societe;118;140;69;59;35;86;507
apr-13;Sport;38;33;30;21;0;18;140
may-13;Catastrophes;54;62;40;16;2;36;210
may-13;Culture-loisirs;56;34;39;13;29;53;224
may-13;Economie;49;71;38;37;13;25;233
may-13;Education;16;23;8;3;3;10;63
may-13;Environnement;24;34;27;8;9;13;115
may-13;Faits divers;34;63;31;30;2;52;212
may-13;Histoire-hommages;13;15;8;4;10;8;58
may-13;International;26;60;22;36;103;33;280
may-13;Justice;32;42;31;37;16;29;187
may-13;Politique France;55;75;36;29;16;39;250
may-13;Sante;28;33;26;17;3;24;131
may-13;Sciences et techniques;12;16;7;6;2;4;47
may-13;Societe;75;90;69;41;43;74;392
may-13;Sport;63;48;34;26;0;23;194
jun-13;Catastrophes;60;62;39;21;5;42;229
jun-13;Culture-loisirs;65;32;22;14;30;52;215
jun-13;Economie;41;84;35;26;17;36;239
jun-13;Education;26;22;18;6;0;15;87
jun-13;Environnement;20;39;12;8;3;19;101
jun-13;Faits divers;16;17;22;9;1;28;93
jun-13;Histoire-hommages;13;21;12;9;5;8;68
jun-13;International;55;67;44;63;115;43;387
jun-13;Justice;27;47;35;48;25;32;214
jun-13;Politique France;52;55;44;33;12;44;240
jun-13;Sante;18;34;18;14;2;24;110
jun-13;Sciences et techniques;8;7;2;8;1;7;33
jun-13;Societe;79;119;79;56;26;73;432
jun-13;Sport;46;47;31;24;0;36;184
jul-13;Catastrophes;96;141;74;50;10;83;454
jul-13;Culture-loisirs;74;53;23;7;33;53;243
jul-13;Economie;63;67;43;25;16;38;252
jul-13;Education;10;12;7;2;0;6;37
jul-13;Environnement;49;59;27;13;3;22;173
jul-13;Faits divers;28;35;24;25;2;38;152
jul-13;Histoire-hommages;9;8;8;1;1;5;32
jul-13;International;54;75;50;62;160;47;448
jul-13;Justice;27;44;25;41;44;23;204
jul-13;Politique France;51;81;48;32;7;41;260
jul-13;Sante;19;27;21;7;1;14;89
jul-13;Sciences et techniques;11;17;8;4;1;11;52
jul-13;Societe;148;192;101;90;32;132;695
jul-13;Sport;57;66;53;50;0;40;266
aug-13;Catastrophes;34;56;38;18;3;24;173
aug-13;Culture-loisirs;70;50;25;12;26;39;222
aug-13;Economie;62;91;52;19;15;31;270
aug-13;Education;19;8;11;5;0;12;55
aug-13;Environnement;26;31;19;11;11;7;105
aug-13;Faits divers;57;63;49;42;5;53;269
aug-13;Histoire-hommages;8;4;5;5;6;2;30
aug-13;International;59;102;47;63;110;53;434
aug-13;Justice;17;27;20;21;19;23;127
aug-13;Politique France;23;29;23;12;3;25;115
aug-13;Sante;13;6;17;5;7;10;58
aug-13;Sciences et techniques;17;19;10;4;1;10;61
aug-13;Societe;96;142;58;63;19;88;466
aug-13;Sport;44;52;24;21;1;21;163
sep-13;Catastrophes;16;30;17;12;3;19;97
sep-13;Culture-loisirs;56;35;32;7;27;43;200
sep-13;Economie;53;74;42;34;16;27;246
sep-13;Education;21;30;10;8;2;19;90
sep-13;Environnement;23;39;22;15;13;15;127
sep-13;Faits divers;47;61;41;17;1;56;223
sep-13;Histoire-hommages;5;13;6;5;4;4;37
sep-13;International;95;120;76;53;120;65;529
sep-13;Justice;14;17;19;15;13;18;96
sep-13;Politique France;30;45;32;15;6;27;155
sep-13;Sante;18;17;16;9;3;9;72
sep-13;Sciences et techniques;15;7;4;6;1;5;38
sep-13;Societe;75;92;64;41;22;77;371
sep-13;Sport;44;39;14;15;1;27;140
oct-13;Catastrophes;40;63;42;15;18;33;211
oct-13;Culture-loisirs;71;49;26;14;34;65;259
oct-13;Economie;88;117;87;46;23;57;418
oct-13;Education;19;17;10;1;1;4;52
oct-13;Environnement;20;36;15;15;7;14;107
oct-13;Faits divers;31;37;34;13;1;44;160
oct-13;Histoire-hommages;11;15;14;4;13;10;67
oct-13;International;71;97;38;63;125;43;437
oct-13;Justice;30;31;34;18;14;28;155
oct-13;Politique France;63;89;50;34;15;55;306
oct-13;Sante;32;24;25;12;5;27;125
oct-13;Sciences et techniques;11;21;7;11;5;11;66
oct-13;Societe;101;157;84;70;39;128;579
oct-13;Sport;52;40;31;15;1;22;161
nov-13;Catastrophes;48;57;34;17;11;22;189
nov-13;Culture-loisirs;47;41;13;16;25;45;187
nov-13;Economie;92;109;71;41;20;66;399
nov-13;Education;7;6;8;5;3;7;36
nov-13;Environnement;10;26;21;6;13;14;90
nov-13;Faits divers;33;37;41;15;1;46;173
nov-13;Histoire-hommages;27;31;23;10;16;17;124
nov-13;International;52;78;40;61;102;46;379
nov-13;Justice;12;15;25;19;7;32;110
nov-13;Politique France;28;28;29;26;5;20;136
nov-13;Sante;11;18;16;3;0;11;59
nov-13;Sciences et techniques;6;15;8;5;4;8;46
nov-13;Societe;74;93;66;54;32;60;379
nov-13;Sport;52;32;27;24;2;26;163
dec-13;Catastrophes;58;60;51;33;0;40;242
dec-13;Culture-loisirs;71;69;26;12;33;59;270
dec-13;Economie;86;113;66;31;16;41;353
dec-13;Education;10;12;7;4;2;8;43
dec-13;Environnement;23;31;23;14;3;15;109
dec-13;Faits divers;43;40;38;19;3;48;191
dec-13;Histoire-hommages;46;54;37;26;15;33;211
dec-13;International;79;101;57;87;141;53;518
dec-13;Justice;18;16;24;14;16;26;114
dec-13;Politique France;28;36;31;29;5;21;150
dec-13;Sante;17;20;19;7;3;22;88
dec-13;Sciences et techniques;9;14;13;7;6;11;60
dec-13;Societe;117;158;114;71;44;113;617
dec-13;Sport;33;27;22;11;0;20;113
jan-14;Catastrophes;61;71;47;13;2;49;243
jan-14;Culture-loisirs;50;40;16;13;22;40;181
jan-14;Economie;46;61;34;26;14;29;210
jan-14;Education;18;13;12;3;3;10;59
jan-14;Environnement;29;29;35;14;10;12;129
jan-14;Faits divers;20;20;21;13;1;34;109
jan-14;Histoire-hommages;9;13;13;5;12;9;61
jan-14;International;46;72;35;55;124;36;368
jan-14;Justice;32;34;33;21;12;41;173
jan-14;Politique France;31;35;31;14;5;24;140
jan-14;Sante;28;25;25;10;1;22;111
jan-14;Sciences et techniques;13;7;12;12;2;6;52
jan-14;Societe;114;146;78;63;22;110;533
jan-14;Sport;44;32;24;18;2;23;143
feb-14;Catastrophes;58;54;50;15;2;57;236
feb-14;Culture-loisirs;45;41;16;14;28;41;185
feb-14;Economie;70;76;46;24;14;38;268
feb-14;Education;13;7;1;0;2;5;28
feb-14;Environnement;47;64;28;9;5;24;177
feb-14;Faits divers;17;28;18;14;3;44;124
feb-14;Histoire-hommages;6;10;4;5;9;3;37
feb-14;International;64;99;47;64;115;60;449
feb-14;Justice;20;19;22;23;15;29;128
feb-14;Politique France;22;20;15;13;9;11;90
feb-14;Sante;15;16;17;7;2;10;67
feb-14;Sciences et techniques;12;11;2;5;1;7;38
feb-14;Societe;91;90;56;49;26;103;415
feb-14;Sport;73;117;33;18;5;39;285
mar-14;Catastrophes;51;53;29;16;10;34;193
mar-14;Culture-loisirs;37;32;23;17;28;44;181
mar-14;Economie;39;60;34;17;10;24;184
mar-14;Education;7;9;4;1;5;7;33
mar-14;Environnement;47;55;37;16;6;27;188
mar-14;Faits divers;11;11;10;12;0;28;72
mar-14;Histoire-hommages;11;12;12;5;10;7;57
mar-14;International;87;111;46;60;113;41;458
mar-14;Justice;45;50;39;45;20;49;248
mar-14;Politique France;55;77;62;26;15;60;295
mar-14;Sante;14;21;16;9;3;14;77
mar-14;Sciences et techniques;11;12;5;6;3;6;43
mar-14;Societe;64;69;43;40;18;66;300
mar-14;Sport;32;35;20;18;0;17;122
apr-14;Catastrophes;18;36;16;20;9;21;120
apr-14;Culture-loisirs;53;50;20;21;35;42;221
apr-14;Economie;67;79;58;26;19;42;291
apr-14;Education;11;8;8;0;2;9;38
apr-14;Environnement;23;27;17;4;4;4;79
apr-14;Faits divers;24;33;34;14;1;54;160
apr-14;Histoire-hommages;21;22;17;8;11;10;89
apr-14;International;74;114;63;78;144;77;550
apr-14;Justice;24;30;35;22;10;43;164
apr-14;Politique France;112;146;94;54;24;73;503
apr-14;Sante;19;22;20;1;6;22;90
apr-14;Sciences et techniques;15;16;12;7;3;13;66
apr-14;Societe;99;130;81;47;35;104;496
apr-14;Sport;46;40;31;39;0;24;180
may-14;Catastrophes;25;32;22;10;10;31;130
may-14;Culture-loisirs;60;33;29;21;23;46;212
may-14;Economie;42;82;43;31;7;32;237
may-14;Education;16;9;6;1;0;6;38
may-14;Environnement;20;23;9;5;2;5;64
may-14;Faits divers;23;29;30;7;0;43;132
may-14;Histoire-hommages;18;24;19;6;9;6;82
may-14;International;114;155;79;77;138;88;651
may-14;Justice;28;36;36;21;7;34;162
may-14;Politique France;23;38;34;15;8;22;140
may-14;Sante;15;9;16;7;2;20;69
may-14;Sciences et techniques;8;17;2;4;1;11;43
may-14;Societe;58;87;64;30;25;75;339
may-14;Sport;52;47;27;27;0;26;179
jun-14;Catastrophes;10;24;10;8;3;24;79
jun-14;Culture-loisirs;23;40;18;18;30;43;172
jun-14;Economie;30;57;27;14;13;24;165
jun-14;Education;21;13;17;6;3;19;79
jun-14;Environnement;12;24;15;3;3;9;66
jun-14;Faits divers;16;19;18;14;1;37;105
jun-14;Histoire-hommages;45;57;39;13;6;32;192
jun-14;International;48;89;35;62;124;47;405
jun-14;Justice;28;41;33;34;17;39;192
jun-14;Politique France;32;43;15;12;7;18;127
jun-14;Sante;6;5;8;2;2;11;34
jun-14;Sciences et techniques;3;8;4;5;0;7;27
jun-14;Societe;98;126;83;48;21;95;471
jun-14;Sport;150;93;57;46;2;77;425
jul-14;Catastrophes;131;140;87;41;26;88;513
jul-14;Culture-loisirs;49;40;31;27;35;43;225
jul-14;Economie;51;65;43;15;12;36;222
jul-14;Education;9;10;10;4;2;7;42
jul-14;Environnement;19;38;20;9;4;14;104
jul-14;Faits divers;20;29;24;15;1;28;117
jul-14;Histoire-hommages;17;19;12;8;9;4;69
jul-14;International;68;115;43;83;143;60;512
jul-14;Justice;26;45;33;25;13;39;181
jul-14;Politique France;37;47;38;23;10;27;182
jul-14;Sante;9;22;13;12;6;8;70
jul-14;Sciences et techniques;5;15;7;9;0;2;38
jul-14;Societe;95;123;91;47;30;97;483
jul-14;Sport;152;112;69;58;9;87;487
aug-14;Catastrophes;32;45;35;14;5;25;156
aug-14;Culture-loisirs;62;37;12;18;26;42;197
aug-14;Economie;66;68;43;18;12;34;241
aug-14;Education;17;8;4;2;0;11;42
aug-14;Environnement;27;23;11;5;3;10;79
aug-14;Faits divers;16;31;29;8;2;30;116
aug-14;Histoire-hommages;29;30;26;14;13;20;132
aug-14;International;75;113;54;82;120;62;506
aug-14;Justice;16;26;16;13;4;15;90
aug-14;Politique France;48;55;45;24;10;30;212
aug-14;Sante;11;27;13;18;13;7;89
aug-14;Sciences et techniques;12;11;5;9;2;10;49
aug-14;Societe;51;99;76;37;29;72;364
aug-14;Sport;47;74;35;29;0;33;218
sep-14;Catastrophes;40;54;40;7;6;47;194
sep-14;Culture-loisirs;63;43;24;20;30;56;236
sep-14;Economie;66;85;60;30;6;43;290
sep-14;Education;23;20;20;5;2;32;102
sep-14;Environnement;24;32;19;7;6;7;95
sep-14;Faits divers;21;30;26;6;1;44;128
sep-14;Histoire-hommages;10;9;8;3;5;0;35
sep-14;International;132;163;67;86;177;72;697
sep-14;Justice;27;29;27;16;6;36;141
sep-14;Politique France;74;103;76;32;14;56;355
sep-14;Sante;18;30;22;19;12;26;127
sep-14;Sciences et techniques;7;16;8;6;1;9;47
sep-14;Societe;109;134;92;42;22;85;484
sep-14;Sport;45;40;23;42;0;16;166
oct-14;Catastrophes;43;51;31;12;3;34;174
oct-14;Culture-loisirs;45;30;28;28;26;33;190
oct-14;Economie;67;81;63;17;11;35;274
oct-14;Education;10;5;2;2;1;2;22
oct-14;Environnement;47;55;35;13;2;32;184
oct-14;Faits divers;17;22;23;10;2;31;105
oct-14;Histoire-hommages;4;9;5;2;5;2;27
oct-14;International;54;99;47;58;121;47;426
oct-14;Justice;24;26;25;16;8;32;131
oct-14;Politique France;37;37;27;22;8;15;146
oct-14;Sante;27;57;49;17;19;49;218
oct-14;Sciences et techniques;10;10;10;1;3;8;42
oct-14;Societe;57;102;98;29;27;70;383
oct-14;Sport;48;33;25;32;0;17;155
nov-14;Catastrophes;40;50;42;6;3;36;177
nov-14;Culture-loisirs;48;38;32;20;21;52;211
nov-14;Economie;50;69;38;19;15;23;214
nov-14;Education;9;9;4;1;0;7;30
nov-14;Environnement;56;32;28;11;13;20;160
nov-14;Faits divers;21;23;20;7;0;43;114
nov-14;Histoire-hommages;25;22;20;5;10;8;90
nov-14;International;58;84;44;48;105;42;381
nov-14;Justice;32;39;31;19;16;31;168
nov-14;Politique France;37;57;35;29;4;22;184
nov-14;Sante;16;14;18;4;7;20;79
nov-14;Sciences et techniques;17;22;8;7;5;12;71
nov-14;Societe;84;86;59;43;33;86;391
nov-14;Sport;38;39;26;41;0;30;174
dec-14;Catastrophes;74;88;57;16;16;56;307
dec-14;Culture-loisirs;80;55;44;28;25;74;306
dec-14;Economie;79;86;61;22;24;44;316
dec-14;Education;11;8;6;5;1;5;36
dec-14;Environnement;33;43;24;10;12;17;139
dec-14;Faits divers;25;31;29;17;10;47;159
dec-14;Histoire-hommages;6;20;11;2;6;4;49
dec-14;International;60;91;35;51;128;37;402
dec-14;Justice;13;16;11;11;14;32;97
dec-14;Politique France;49;50;39;23;7;20;188
dec-14;Sante;25;30;26;7;10;20;118
dec-14;Sciences et techniques;11;10;6;7;3;6;43
dec-14;Societe;141;182;118;65;46;130;682
dec-14;Sport;31;27;17;43;0;16;134
jan-15;Catastrophes;29;27;35;7;5;34;137
jan-15;Culture-loisirs;41;34;18;26;25;47;191
jan-15;Economie;39;48;23;13;8;16;147
jan-15;Education;8;10;6;2;3;8;37
jan-15;Environnement;21;15;8;4;1;8;57
jan-15;Faits divers;6;6;10;4;0;6;32
jan-15;Histoire-hommages;16;14;13;10;11;13;77
jan-15;International;65;98;51;55;108;44;421
jan-15;Justice;13;8;11;13;6;20;71
jan-15;Politique France;223;262;144;79;58;191;957
jan-15;Sante;18;17;13;5;2;20;75
jan-15;Sciences et techniques;10;4;3;3;0;5;25
jan-15;Societe;72;91;67;27;32;79;368
jan-15;Sport;25;23;13;26;0;10;97
feb-15;Catastrophes;48;38;37;4;3;26;156
feb-15;Culture-loisirs;54;37;23;27;26;40;207
feb-15;Economie;84;107;66;29;40;51;377
feb-15;Education;16;7;6;2;1;8;40
feb-15;Environnement;32;27;26;6;2;15;108
feb-15;Faits divers;22;28;20;9;3;25;107
feb-15;Histoire-hommages;7;16;9;2;6;4;44
feb-15;International;65;92;60;52;114;51;434
feb-15;Justice;22;26;17;23;11;29;128
feb-15;Politique France;50;62;33;20;10;45;220
feb-15;Sante;15;12;15;3;2;17;64
feb-15;Sciences et techniques;8;8;5;5;0;5;31
feb-15;Societe;50;76;54;41;20;68;309
feb-15;Sport;41;41;25;27;1;27;162
mar-15;Catastrophes;97;133;72;27;15;74;418
mar-15;Culture-loisirs;45;30;25;27;23;42;192
mar-15;Economie;51;62;35;21;17;18;204
mar-15;Education;15;12;7;3;0;9;46
mar-15;Environnement;41;41;43;9;10;30;174
mar-15;Faits divers;53;59;39;23;8;57;239
mar-15;Histoire-hommages;6;9;6;1;9;1;32
mar-15;International;64;99;38;42;160;55;458
mar-15;Justice;11;21;18;18;13;27;108
mar-15;Politique France;102;138;58;34;15;91;438
mar-15;Sante;29;25;17;7;2;23;103
mar-15;Sciences et techniques;14;25;12;3;4;17;75
mar-15;Societe;91;83;68;39;40;94;415
mar-15;Sport;36;34;34;41;1;27;173
apr-15;Catastrophes;69;64;53;25;12;57;280
apr-15;Culture-loisirs;43;36;36;34;26;39;214
apr-15;Economie;44;80;50;15;17;40;246
apr-15;Education;13;10;4;0;3;4;34
apr-15;Environnement;17;17;7;6;2;11;60
apr-15;Faits divers;48;51;45;21;2;54;221
apr-15;Histoire-hommages;29;26;30;11;24;19;139
apr-15;International;32;55;19;29;88;35;258
apr-15;Justice;21;18;9;7;13;33;101
apr-15;Politique France;48;56;48;30;17;34;233
apr-15;Sante;25;7;15;6;2;17;72
apr-15;Sciences et techniques;11;10;7;7;5;9;49
apr-15;Societe;73;110;51;32;29;89;384
apr-15;Sport;33;22;20;34;0;16;125
may-15;Catastrophes;27;23;21;5;8;28;112
may-15;Culture-loisirs;50;39;29;23;26;58;225
may-15;Economie;49;89;47;12;5;25;227
may-15;Education;24;22;19;4;4;20;93
may-15;Environnement;18;26;17;4;9;4;78
may-15;Faits divers;16;15;24;4;1;18;78
may-15;Histoire-hommages;21;24;17;10;11;13;96
may-15;International;51;98;35;52;128;48;412
may-15;Justice;25;15;18;15;12;29;114
may-15;Politique France;33;34;32;18;6;25;148
may-15;Sante;20;20;12;4;2;26;84
may-15;Sciences et techniques;16;6;6;3;0;12;43
may-15;Societe;98;97;54;21;27;81;378
may-15;Sport;47;28;25;40;4;28;172
jun-15;Catastrophes;32;26;13;10;3;34;118
jun-15;Culture-loisirs;51;40;24;29;34;60;238
jun-15;Economie;77;142;70;42;47;57;435
jun-15;Education;21;23;8;2;0;14;68
jun-15;Environnement;39;31;27;4;14;22;137
jun-15;Faits divers;25;18;27;11;6;42;129
jun-15;Histoire-hommages;23;14;13;7;6;14;77
jun-15;International;89;117;55;69;124;64;518
jun-15;Justice;27;23;24;25;17;33;149
jun-15;Politique France;79;84;68;49;11;66;357
jun-15;Sante;23;8;16;8;5;32;92
jun-15;Sciences et techniques;10;15;11;4;6;16;62
jun-15;Societe;89;106;83;46;29;79;432
jun-15;Sport;59;46;38;54;4;43;244
jul-15;Catastrophes;32;55;44;15;4;34;184
jul-15;Culture-loisirs;57;22;30;36;28;50;223
jul-15;Economie;126;154;90;56;56;78;560
jul-15;Education;5;5;3;3;0;9;25
jul-15;Environnement;28;32;25;8;2;14;109
jul-15;Faits divers;8;13;10;7;9;19;66
jul-15;Histoire-hommages;4;8;7;4;4;4;31
jul-15;International;50;89;42;42;103;41;367
jul-15;Justice;4;17;8;8;6;21;64
jul-15;Politique France;43;31;30;23;5;26;158
jul-15;Sante;11;5;10;9;2;15;52
jul-15;Sciences et techniques;20;12;7;3;3;13;58
jul-15;Societe;79;90;50;31;18;76;344
jul-15;Sport;51;54;47;53;4;41;250
aug-15;Catastrophes;31;62;43;11;18;51;216
aug-15;Culture-loisirs;54;33;19;25;27;48;206
aug-15;Economie;96;104;70;42;21;50;383
aug-15;Education;13;5;7;4;2;9;40
aug-15;Environnement;27;37;21;8;7;23;123
aug-15;Faits divers;25;22;22;15;3;30;117
aug-15;Histoire-hommages;4;9;6;1;7;5;32
aug-15;International;47;63;30;39;118;37;334
aug-15;Justice;7;13;13;11;10;8;62
aug-15;Politique France;55;52;49;28;14;45;243
aug-15;Sante;9;11;4;6;2;11;43
aug-15;Sciences et techniques;18;12;13;5;3;12;63
aug-15;Societe;93;87;68;22;23;72;365
aug-15;Sport;41;39;31;39;2;29;181
sep-15;Catastrophes;23;39;31;5;1;35;134
sep-15;Culture-loisirs;48;33;30;11;26;54;202
sep-15;Economie;65;100;39;13;11;37;265
sep-15;Education;31;18;22;7;0;20;98
sep-15;Environnement;42;56;33;19;19;26;195
sep-15;Faits divers;12;13;19;7;3;21;75
sep-15;Histoire-hommages;9;7;8;4;6;5;39
sep-15;International;97;156;87;48;149;83;620
sep-15;Justice;19;18;16;14;8;31;106
sep-15;Politique France;59;86;59;16;21;45;286
sep-15;Sante;15;9;20;4;1;17;66
sep-15;Sciences et techniques;21;13;8;3;7;13;65
sep-15;Societe;108;119;66;27;36;94;450
sep-15;Sport;85;37;26;45;2;32;227
oct-15;Catastrophes;74;79;49;14;9;55;280
oct-15;Culture-loisirs;44;33;22;10;27;51;187
oct-15;Economie;32;61;19;9;10;17;148
oct-15;Education;8;16;6;4;2;6;42
oct-15;Environnement;34;19;25;5;9;19;111
oct-15;Faits divers;19;26;22;6;5;30;108
oct-15;Histoire-hommages;5;9;4;2;3;4;27
oct-15;International;53;91;41;43;152;53;433
oct-15;Justice;22;25;28;23;6;35;139
oct-15;Politique France;34;35;32;10;13;23;147
oct-15;Sante;17;15;14;5;2;15;68
oct-15;Sciences et techniques;3;8;7;2;3;9;32
oct-15;Societe;94;100;73;35;23;77;402
oct-15;Sport;65;22;23;35;2;16;163
nov-15;Catastrophes;43;40;33;10;6;38;170
nov-15;Culture-loisirs;33;22;8;6;22;40;131
nov-15;Economie;34;53;33;3;3;19;145
nov-15;Education;5;2;4;1;1;3;16
nov-15;Environnement;52;37;32;15;7;18;161
nov-15;Faits divers;12;7;7;5;1;13;45
nov-15;Histoire-hommages;6;7;4;5;10;6;38
nov-15;International;99;133;57;64;117;90;560
nov-15;Justice;16;11;14;16;1;20;78
nov-15;Politique France;169;215;149;85;49;152;819
nov-15;Sante;10;8;9;5;1;16;49
nov-15;Sciences et techniques;10;7;4;3;4;11;39
nov-15;Societe;42;39;24;20;14;46;185
nov-15;Sport;17;13;10;27;4;18;89
dec-15;Catastrophes;6;19;10;6;2;18;61
dec-15;Culture-loisirs;75;40;29;21;30;63;258
dec-15;Economie;54;60;38;10;6;35;203
dec-15;Education;5;7;3;1;2;6;24
dec-15;Environnement;87;84;69;25;48;52;365
dec-15;Faits divers;18;22;28;7;5;24;104
dec-15;Histoire-hommages;8;9;4;2;4;1;28
dec-15;International;53;112;56;44;122;42;429
dec-15;Justice;16;13;15;13;11;17;85
dec-15;Politique France;128;125;99;54;37;145;588
dec-15;Sante;19;11;21;4;3;15;73
dec-15;Sciences et techniques;12;9;4;1;3;3;32
dec-15;Societe;95;97;62;24;21;77;376
dec-15;Sport;27;14;12;35;2;25;115
jan-16;Catastrophes;24;32;29;6;2;30;123
jan-16;Culture-loisirs;47;41;15;11;23;42;179
jan-16;Economie;53;56;32;13;7;26;187
jan-16;Education;16;5;6;0;4;12;43
jan-16;Environnement;40;31;29;6;6;16;128
jan-16;Faits divers;15;24;23;11;20;33;126
jan-16;Histoire-hommages;22;27;21;18;16;22;126
jan-16;International;45;76;26;48;92;39;326
jan-16;Justice;20;16;22;11;12;26;107
jan-16;Politique France;79;95;68;42;24;57;365
jan-16;Sante;23;24;23;7;6;18;101
jan-16;Sciences et techniques;12;7;7;5;1;10;42
jan-16;Societe;84;102;75;22;22;97;402
jan-16;Sport;27;20;15;10;0;14;86
feb-16;Catastrophes;41;49;42;8;5;47;192
feb-16;Culture-loisirs;43;33;21;8;31;54;190
feb-16;Economie;75;86;58;10;12;47;288
feb-16;Education;10;3;2;1;0;6;22
feb-16;Environnement;14;20;9;0;3;9;55
feb-16;Faits divers;12;14;16;3;6;27;78
feb-16;Histoire-hommages;8;9;6;5;7;3;38
feb-16;International;63;113;34;50;122;50;432
feb-16;Justice;16;23;23;15;5;26;108
feb-16;Politique France;66;68;57;41;15;46;293
feb-16;Sante;20;9;8;7;4;18;66
feb-16;Sciences et techniques;12;8;4;2;2;4;32
feb-16;Societe;83;84;70;27;22;82;368
feb-16;Sport;32;15;15;21;3;29;115
mar-16;Catastrophes;17;18;32;6;1;21;95
mar-16;Culture-loisirs;58;49;22;9;34;49;221
mar-16;Economie;65;75;60;12;4;44;260
mar-16;Education;7;4;4;1;2;9;27
mar-16;Environnement;18;17;15;5;10;15;80
mar-16;Faits divers;14;18;17;7;2;27;85
mar-16;Histoire-hommages;21;18;11;7;9;12;78
mar-16;International;158;214;128;103;180;158;941
mar-16;Justice;12;12;14;5;6;18;67
mar-16;Politique France;53;73;50;30;8;49;263
mar-16;Sante;18;12;12;7;2;23;74
mar-16;Sciences et techniques;17;19;10;3;7;14;70
mar-16;Societe;122;135;96;50;20;108;531
mar-16;Sport;45;22;18;29;0;25;139
apr-16;Catastrophes;16;15;19;3;8;18;79
apr-16;Culture-loisirs;47;20;18;6;29;43;163
apr-16;Economie;66;64;41;13;8;30;222
apr-16;Education;14;5;8;0;1;8;36
apr-16;Environnement;21;16;21;3;17;15;93
apr-16;Faits divers;12;11;12;9;1;29;74
apr-16;Histoire-hommages;13;16;14;3;6;11;63
apr-16;International;67;98;39;49;106;59;418
apr-16;Justice;21;39;26;19;19;32;156
apr-16;Politique France;39;48;37;17;6;32;179
apr-16;Sante;20;11;9;0;4;16;60
apr-16;Sciences et techniques;18;18;12;1;3;16;68
apr-16;Societe;105;122;100;50;34;122;533
apr-16;Sport;35;26;27;31;0;28;147
may-16;Catastrophes;97;125;96;40;7;66;431
may-16;Culture-loisirs;59;49;42;15;36;64;265
may-16;Economie;42;69;27;6;18;38;200
may-16;Education;15;12;12;1;2;12;54
may-16;Environnement;19;22;14;4;8;8;75
may-16;Faits divers;18;21;23;12;4;39;117
may-16;Histoire-hommages;15;20;12;8;14;16;85
may-16;International;37;82;31;43;140;46;379
may-16;Justice;17;19;20;18;9;26;109
may-16;Politique France;42;56;34;22;14;35;203
may-16;Sante;13;10;6;1;1;21;52
may-16;Sciences et techniques;19;9;10;2;6;11;57
may-16;Societe;156;196;126;43;37;136;694
may-16;Sport;62;44;28;41;4;62;241
jun-16;Catastrophes;49;54;59;8;5;40;215
jun-16;Culture-loisirs;23;20;15;3;17;32;110
jun-16;Economie;21;28;14;2;9;15;89
jun-16;Education;15;4;7;1;1;11;39
jun-16;Environnement;12;18;11;2;5;10;58
jun-16;Faits divers;12;13;11;4;3;14;57
jun-16;Histoire-hommages;11;12;11;5;11;10;60
jun-16;International;107;144;88;45;138;88;610
jun-16;Justice;5;8;10;5;6;8;42
jun-16;Politique France;69;81;45;30;13;47;285
jun-16;Sante;6;4;3;1;0;8;22
jun-16;Sciences et techniques;10;7;3;2;2;2;26
jun-16;Societe;64;87;58;27;27;60;323
jun-16;Sport;129;55;80;43;9;214;530
jul-16;Catastrophes;20;22;16;0;2;23;83
jul-16;Culture-loisirs;38;27;19;0;26;26;136
jul-16;Economie;34;37;22;0;7;12;112
jul-16;Education;4;5;3;0;0;9;21
jul-16;Environnement;17;7;2;0;3;3;32
jul-16;Faits divers;12;11;10;0;4;15;52
jul-16;Histoire-hommages;21;19;11;0;4;5;60
jul-16;International;53;95;39;0;111;50;348
jul-16;Justice;8;7;5;0;8;11;39
jul-16;Politique France;162;171;120;0;33;157;643
jul-16;Sante;10;3;5;0;3;2;23
jul-16;Sciences et techniques;17;10;2;0;4;4;37
jul-16;Societe;53;44;41;0;22;48;208
jul-16;Sport;131;99;85;0;9;151;475
aug-16;Catastrophes;56;64;57;0;5;54;236
aug-16;Culture-loisirs;60;28;23;0;35;54;200
aug-16;Economie;89;73;48;0;13;36;259
aug-16;Education;26;8;9;0;0;17;60
aug-16;Environnement;33;25;16;0;4;11;89
aug-16;Faits divers;25;21;23;0;3;36;108
aug-16;Histoire-hommages;7;8;5;0;9;3;32
aug-16;International;37;72;31;0;166;52;358
aug-16;Justice;17;13;10;0;11;18;69
aug-16;Politique France;70;83;66;0;15;55;289
aug-16;Sante;11;7;7;0;4;10;39
aug-16;Sciences et techniques;10;9;4;0;6;13;42
aug-16;Societe;96;78;49;0;26;71;320
aug-16;Sport;118;166;90;0;9;60;443
sep-16;Catastrophes;18;17;21;0;3;15;74
sep-16;Culture-loisirs;40;34;20;0;28;45;167
sep-16;Economie;75;61;48;0;17;36;237
sep-16;Education;12;7;4;0;0;13;36
sep-16;Environnement;18;25;20;0;3;10;76
sep-16;Faits divers;12;16;14;0;2;21;65
sep-16;Histoire-hommages;12;12;13;0;13;11;61
sep-16;International;56;84;37;0;122;55;354
sep-16;Justice;27;28;20;0;11;25;111
sep-16;Politique France;76;107;74;0;14;65;336
sep-16;Sante;21;10;17;0;3;17;68
sep-16;Sciences et techniques;19;14;6;0;6;7;52
sep-16;Societe;71;57;61;0;25;75;289
sep-16;Sport;34;28;21;0;2;24;109
oct-16;Catastrophes;31;31;25;0;8;36;131
oct-16;Culture-loisirs;40;22;23;0;23;42;150
oct-16;Economie;39;62;47;0;9;32;189
oct-16;Education;7;6;3;0;2;16;34
oct-16;Environnement;12;17;11;0;4;11;55
oct-16;Faits divers;21;32;28;0;7;35;123
oct-16;Histoire-hommages;8;8;10;0;3;4;33
oct-16;International;77;112;50;0;123;50;412
oct-16;Justice;9;9;10;0;2;12;42
oct-16;Politique France;92;92;85;0;26;62;357
oct-16;Sante;13;7;11;0;2;15;48
oct-16;Sciences et techniques;16;8;5;0;8;9;46
oct-16;Societe;58;63;46;0;27;65;259
oct-16;Sport;21;11;12;0;0;15;59
nov-16;Catastrophes;24;28;26;0;7;33;118
nov-16;Culture-loisirs;40;17;14;0;21;54;146
nov-16;Economie;34;53;43;0;9;32;171
nov-16;Education;9;12;3;0;1;10;35
nov-16;Environnement;17;12;22;0;12;10;73
nov-16;Faits divers;12;12;21;0;1;29;75
nov-16;Histoire-hommages;19;18;17;0;11;18;83
nov-16;International;110;150;62;0;162;92;576
nov-16;Justice;10;11;14;0;4;24;63
nov-16;Politique France;179;207;153;0;23;134;696
nov-16;Sante;21;8;15;0;4;18;66
nov-16;Sciences et techniques;37;16;13;0;4;17;87
nov-16;Societe;53;62;59;0;29;76;279
nov-16;Sport;33;15;18;0;1;26;93
dec-16;Catastrophes;14;12;7;0;8;16;57
dec-16;Culture-loisirs;54;25;25;0;27;50;181
dec-16;Economie;41;51;31;0;11;28;162
dec-16;Education;12;3;3;0;1;2;21
dec-16;Environnement;33;30;29;0;5;23;120
dec-16;Faits divers;7;5;12;0;3;21;48
dec-16;Histoire-hommages;17;21;22;0;13;17;90
dec-16;International;86;131;66;0;135;74;492
dec-16;Justice;22;24;35;0;13;27;121
dec-16;Politique France;67;58;51;0;8;51;235
dec-16;Sante;16;11;10;0;2;20;59
dec-16;Sciences et techniques;9;10;9;0;1;5;34
dec-16;Societe;90;71;58;0;26;77;322
dec-16;Sport;24;20;18;0;2;18;82
jan-17;Catastrophes;50;59;49;0;3;46;207
jan-17;Culture-loisirs;48;33;27;0;34;55;197
jan-17;Economie;44;70;40;0;9;49;212
jan-17;Education;14;7;5;0;2;3;31
jan-17;Environnement;42;35;27;0;6;26;136
jan-17;Faits divers;10;13;20;0;4;27;74
jan-17;Histoire-hommages;9;12;8;0;11;10;50
jan-17;International;57;110;51;0;163;70;451
jan-17;Justice;13;14;20;0;11;26;84
jan-17;Politique France;174;141;114;0;26;130;585
jan-17;Sante;19;18;28;0;3;21;89
jan-17;Sciences et techniques;26;12;7;0;5;9;59
jan-17;Societe;78;80;71;0;20;83;332
jan-17;Sport;50;26;31;0;1;29;137
feb-17;Catastrophes;19;21;27;0;1;18;86
feb-17;Culture-loisirs;51;30;25;0;27;59;192
feb-17;Economie;67;56;57;0;10;32;222
feb-17;Education;7;7;3;0;1;8;26
feb-17;Environnement;11;10;8;0;1;2;32
feb-17;Faits divers;28;39;37;0;7;38;149
feb-17;Histoire-hommages;1;3;4;0;3;3;14
feb-17;International;34;73;21;0;129;42;299
feb-17;Justice;23;24;17;0;9;23;96
feb-17;Politique France;125;144;101;0;20;81;471
feb-17;Sante;9;8;9;0;1;13;40
feb-17;Sciences et techniques;12;9;4;0;3;12;40
feb-17;Societe;71;47;39;0;18;58;233
feb-17;Sport;21;21;14;0;3;17;76
mar-17;Catastrophes;7;12;15;0;2;10;46
mar-17;Culture-loisirs;21;19;20;0;25;41;126
mar-17;Economie;43;41;23;0;12;25;144
mar-17;Education;10;6;6;0;1;4;27
mar-17;Environnement;12;18;16;0;7;8;61
mar-17;Faits divers;26;23;26;0;2;28;105
mar-17;Histoire-hommages;8;9;7;0;5;10;39
mar-17;International;51;80;50;0;123;53;357
mar-17;Justice;12;13;20;0;14;22;81
mar-17;Politique France;138;157;86;0;17;111;509
mar-17;Sante;15;5;7;0;2;17;46
mar-17;Sciences et techniques;15;8;7;0;8;9;47
mar-17;Societe;74;80;63;0;27;67;311
mar-17;Sport;25;14;11;0;0;11;61
apr-17;Catastrophes;7;4;6;0;2;14;33
apr-17;Culture-loisirs;21;14;15;0;20;36;106
apr-17;Economie;37;31;19;0;10;21;118
apr-17;Education;4;5;0;0;1;1;11
apr-17;Environnement;10;16;14;0;3;3;46
apr-17;Faits divers;5;6;10;0;0;12;33
apr-17;Histoire-hommages;4;5;4;0;5;2;20
apr-17;International;63;101;50;0;118;54;386
apr-17;Justice;5;5;12;0;9;14;45
apr-17;Politique France;145;210;130;0;58;156;699
apr-17;Sante;8;3;7;0;1;9;28
apr-17;Sciences et techniques;15;9;7;0;13;9;53
apr-17;Societe;49;43;47;0;20;71;230
apr-17;Sport;19;13;10;0;0;13;55
may-17;Catastrophes;7;11;12;0;3;7;40
may-17;Culture-loisirs;24;27;30;0;29;55;165
may-17;Economie;55;32;40;0;7;34;168
may-17;Education;12;8;6;0;0;6;32
may-17;Environnement;19;13;18;0;13;18;81
may-17;Faits divers;8;7;14;0;5;19;53
may-17;Histoire-hommages;6;8;7;0;9;10;40
may-17;International;74;92;65;0;134;77;442
may-17;Justice;16;21;15;0;19;24;95
may-17;Politique France;234;306;177;0;55;188;960
may-17;Sante;10;6;7;0;3;21;47
may-17;Sciences et techniques;26;12;14;0;10;9;71
may-17;Societe;57;54;37;0;23;73;244
may-17;Sport;36;26;22;0;0;29;113
jun-17;Catastrophes;24;26;19;0;11;29;109
jun-17;Culture-loisirs;30;21;17;0;17;40;125
jun-17;Economie;31;37;37;0;13;31;149
jun-17;Education;19;14;9;0;0;16;58
jun-17;Environnement;28;16;23;0;8;22;97
jun-17;Faits divers;7;5;7;0;0;1;20
jun-17;Histoire-hommages;16;22;17;0;12;10;77
jun-17;International;53;84;49;0;107;56;349
jun-17;Justice;28;29;21;0;14;25;117
jun-17;Politique France;145;158;102;0;35;104;544
jun-17;Sante;11;5;8;0;4;17;45
jun-17;Sciences et techniques;17;13;5;0;11;8;54
jun-17;Societe;36;42;24;0;21;48;171
jun-17;Sport;26;29;13;0;1;17;86
jul-17;Catastrophes;63;59;47;0;3;47;219
jul-17;Culture-loisirs;44;13;22;0;24;46;149
jul-17;Economie;68;84;39;0;13;34;238
jul-17;Education;13;9;6;0;1;15;44
jul-17;Environnement;29;20;19;0;15;19;102
jul-17;Faits divers;2;3;1;0;1;7;14
jul-17;Histoire-hommages;16;18;12;0;11;15;72
jul-17;International;34;51;33;0;121;49;288
jul-17;Justice;13;17;14;0;8;19;71
jul-17;Politique France;87;87;61;0;13;63;311
jul-17;Sante;10;1;11;0;8;10;40
jul-17;Sciences et techniques;14;4;5;0;8;4;35
jul-17;Societe;64;71;48;0;17;84;284
jul-17;Sport;33;44;40;0;2;39;158
aug-17;Catastrophes;50;48;68;0;17;58;241
aug-17;Culture-loisirs;56;41;24;0;34;46;201
aug-17;Economie;78;89;42;0;16;37;262
aug-17;Education;28;12;11;0;0;9;60
aug-17;Environnement;46;24;15;0;14;9;108
aug-17;Faits divers;14;21;23;0;3;29;90
aug-17;Histoire-hommages;15;13;21;0;13;9;71
aug-17;International;74;116;76;0;173;65;504
aug-17;Justice;6;8;8;0;13;18;53
aug-17;Politique France;69;71;58;0;7;49;254
aug-17;Sante;31;26;20;0;9;25;111
aug-17;Sciences et techniques;12;9;8;0;9;19;57
aug-17;Societe;101;94;65;0;28;89;377
aug-17;Sport;45;42;43;0;4;38;172
sep-17;Catastrophes;103;92;95;16;20;104;430
sep-17;Culture-loisirs;29;19;22;2;21;47;140
sep-17;Economie;58;68;55;13;7;32;233
sep-17;Education;23;10;8;2;3;14;60
sep-17;Environnement;19;17;21;3;9;10;79
sep-17;Faits divers;13;9;18;5;0;20;65
sep-17;Histoire-hommages;6;7;6;2;6;3;30
sep-17;International;45;73;36;25;146;47;372
sep-17;Justice;10;9;7;3;7;8;44
sep-17;Politique France;33;43;28;16;7;29;156
sep-17;Sante;20;7;12;1;4;10;54
sep-17;Sciences et techniques;11;7;4;2;4;9;37
sep-17;Societe;80;93;61;21;26;80;361
sep-17;Sport;40;28;15;9;0;27;119
oct-17;Catastrophes;25;33;28;5;8;35;134
oct-17;Culture-loisirs;43;25;24;6;28;68;194
oct-17;Economie;72;82;55;17;7;42;275
oct-17;Education;20;14;6;2;1;10;53
oct-17;Environnement;16;25;16;6;5;17;85
oct-17;Faits divers;32;33;41;13;10;45;174
oct-17;Histoire-hommages;9;10;8;6;5;8;46
oct-17;International;85;126;69;27;168;74;549
oct-17;Justice;21;24;34;14;10;29;132
oct-17;Politique France;55;79;68;15;12;54;283
oct-17;Sante;19;25;20;3;8;24;99
oct-17;Sciences et techniques;18;9;5;5;17;13;67
oct-17;Societe;98;111;71;23;40;98;441
oct-17;Sport;31;15;9;5;0;21;81
nov-17;Catastrophes;13;16;21;9;4;16;79
nov-17;Culture-loisirs;36;16;12;8;22;46;140
nov-17;Economie;57;80;47;10;8;32;234
nov-17;Education;16;5;10;4;4;11;50
nov-17;Environnement;27;19;14;6;23;15;104
nov-17;Faits divers;21;20;26;4;4;38;113
nov-17;Histoire-hommages;9;10;7;3;7;2;38
nov-17;International;52;64;29;32;94;44;315
nov-17;Justice;19;29;21;8;15;25;117
nov-17;Politique France;40;62;41;14;5;30;192
nov-17;Sante;22;20;20;7;8;25;102
nov-17;Sciences et techniques;14;5;9;1;7;8;44
nov-17;Societe;85;90;67;19;30;96;387
nov-17;Sport;31;22;26;5;1;26;111
dec-17;Catastrophes;60;53;60;8;4;34;219
dec-17;Culture-loisirs;32;16;20;2;18;43;131
dec-17;Economie;63;69;30;6;14;23;205
dec-17;Education;12;5;4;2;0;6;29
dec-17;Environnement;17;28;8;6;9;5;73
dec-17;Faits divers;16;12;28;5;2;20;83
dec-17;Histoire-hommages;66;55;47;5;5;46;224
dec-17;International;34;90;31;25;138;41;359
dec-17;Justice;5;7;14;2;6;10;44
dec-17;Politique France;34;55;37;12;11;44;193
dec-17;Sante;17;17;20;0;3;16;73
dec-17;Sciences et techniques;7;6;3;5;12;10;43
dec-17;Societe;87;82;67;11;28;77;352
dec-17;Sport;24;15;12;5;1;27;84
jan-18;Catastrophes;103;107;115;8;2;59;394
jan-18;Culture-loisirs;45;31;26;7;25;60;194
jan-18;Economie;59;75;38;14;11;28;225
jan-18;Education;16;11;4;2;4;11;48
jan-18;Environnement;42;47;18;9;12;22;150
jan-18;Faits divers;18;23;22;4;4;30;101
jan-18;Histoire-hommages;17;22;12;2;11;17;81
jan-18;International;38;66;33;20;140;53;350
jan-18;Justice;20;30;22;5;8;26;111
jan-18;Politique France;74;82;68;13;17;43;297
jan-18;Sante;31;22;23;6;13;36;131
jan-18;Sciences et techniques;19;7;5;3;13;12;59
jan-18;Societe;98;83;65;23;34;86;389
jan-18;Sport;31;14;15;4;1;31;96
feb-18;Catastrophes;99;55;55;10;2;53;274
feb-18;Culture-loisirs;20;21;23;9;21;47;141
feb-18;Economie;65;60;38;7;11;40;221
feb-18;Education;14;8;2;1;1;10;36
feb-18;Environnement;34;30;31;6;7;29;137
feb-18;Faits divers;30;25;31;5;8;32;131
feb-18;Histoire-hommages;3;4;2;0;9;2;20
feb-18;International;32;70;25;18;120;34;299
feb-18;Justice;31;33;30;14;10;36;154
feb-18;Politique France;40;66;45;18;12;49;230
feb-18;Sante;17;9;10;0;3;14;53
feb-18;Sciences et techniques;14;3;2;6;10;11;46
feb-18;Societe;73;67;44;18;19;58;279
feb-18;Sport;39;48;26;16;2;40;171
mar-18;Catastrophes;20;12;19;3;1;16;71
mar-18;Culture-loisirs;25;25;20;5;26;54;155
mar-18;Economie;39;45;30;6;9;22;151
mar-18;Education;12;9;9;5;0;12;47
mar-18;Environnement;25;20;21;4;9;5;84
mar-18;Faits divers;21;18;17;8;7;28;99
mar-18;Histoire-hommages;9;5;4;3;4;10;35
mar-18;International;62;98;51;23;134;61;429
mar-18;Justice;37;27;34;6;6;38;148
mar-18;Politique France;73;75;58;13;13;58;290
mar-18;Sante;13;18;8;2;2;17;60
mar-18;Sciences et techniques;20;10;3;4;11;12;60
mar-18;Societe;93;113;85;25;26;96;438
mar-18;Sport;23;17;13;7;0;28;88
apr-18;Catastrophes;14;14;14;2;1;12;57
apr-18;Culture-loisirs;17;18;18;4;25;38;120
apr-18;Economie;47;33;27;5;7;29;148
apr-18;Education;23;17;11;4;6;18;79
apr-18;Environnement;22;19;11;1;7;10;70
apr-18;Faits divers;21;12;20;5;6;26;90
apr-18;Histoire-hommages;10;9;12;5;7;11;54
apr-18;International;51;77;34;18;105;62;347
apr-18;Justice;16;20;11;7;11;17;82
apr-18;Politique France;47;55;56;14;15;38;225
apr-18;Sante;15;15;10;1;4;14;59
apr-18;Sciences et techniques;15;2;3;8;12;13;53
apr-18;Societe;154;177;140;28;40;127;666
apr-18;Sport;14;21;7;5;0;19;66
may-18;Catastrophes;33;32;25;4;4;27;125
may-18;Culture-loisirs;25;34;31;13;35;57;195
may-18;Economie;62;69;38;4;10;32;215
may-18;Education;23;18;8;6;4;10;69
may-18;Environnement;28;17;20;2;13;15;95
may-18;Faits divers;29;30;38;7;4;34;142
may-18;Histoire-hommages;10;20;14;3;7;13;67
may-18;International;70;95;41;36;156;54;452
may-18;Justice;9;23;14;6;6;22;80
may-18;Politique France;49;54;55;10;15;32;215
may-18;Sante;16;17;10;7;12;23;85
may-18;Sciences et techniques;17;4;2;3;8;13;47
may-18;Societe;170;169;112;28;39;142;660
may-18;Sport;37;30;15;6;0;70;158
jun-18;Catastrophes;35;39;53;5;5;24;161
jun-18;Culture-loisirs;17;20;15;4;20;49;125
jun-18;Economie;41;61;32;11;8;29;182
jun-18;Education;12;9;8;3;3;16;51
jun-18;Environnement;17;38;18;4;7;12;96
jun-18;Faits divers;15;15;24;7;4;36;101
jun-18;Histoire-hommages;6;10;6;3;4;1;30
jun-18;International;65;97;53;17;137;49;418
jun-18;Justice;14;17;16;3;8;16;74
jun-18;Politique France;24;41;29;6;8;20;128
jun-18;Sante;12;9;9;1;6;15;52
jun-18;Sciences et techniques;10;7;5;4;6;7;39
jun-18;Societe;72;87;64;12;26;75;336
jun-18;Sport;117;53;45;14;4;61;294
jul-18;Catastrophes;53;40;46;0;10;60;209
jul-18;Culture-loisirs;28;20;23;0;32;52;155
jul-18;Economie;66;76;35;0;7;23;207
jul-18;Education;10;4;3;0;0;6;23
jul-18;Environnement;43;40;33;0;19;26;161
jul-18;Faits divers;36;38;38;0;5;27;144
jul-18;Histoire-hommages;4;10;4;0;4;4;26
jul-18;International;17;57;13;0;137;33;257
jul-18;Justice;46;69;57;0;24;48;244
jul-18;Politique France;17;37;28;0;8;17;107
jul-18;Sante;15;13;10;0;7;9;54
jul-18;Sciences et techniques;9;10;4;0;15;7;45
jul-18;Societe;97;80;60;0;33;83;353
jul-18;Sport;168;134;121;0;6;109;538
aug-18;Catastrophes;75;75;60;0;19;58;287
aug-18;Culture-loisirs;35;29;26;0;24;48;162
aug-18;Economie;80;81;42;0;18;33;254
aug-18;Education;18;3;3;0;0;8;32
aug-18;Environnement;50;28;30;0;5;24;137
aug-18;Faits divers;22;23;34;0;4;32;115
aug-18;Histoire-hommages;13;18;18;0;10;17;76
aug-18;International;22;48;29;0;99;28;226
aug-18;Justice;10;12;9;0;7;13;51
aug-18;Politique France;22;37;33;0;2;34;128
aug-18;Sante;23;13;10;0;3;11;60
aug-18;Sciences et techniques;13;7;9;0;12;14;55
aug-18;Societe;94;81;47;0;40;72;334
aug-18;Sport;10;18;21;0;1;25;75
sep-18;Catastrophes;28;32;39;0;7;30;136
sep-18;Culture-loisirs;28;22;25;0;20;55;150
sep-18;Economie;78;72;45;0;15;36;246
sep-18;Education;21;19;6;0;2;18;66
sep-18;Environnement;29;28;23;0;14;15;109
sep-18;Faits divers;12;16;32;0;2;27;89
sep-18;Histoire-hommages;6;15;13;0;5;9;48
sep-18;International;33;71;33;0;112;34;283
sep-18;Justice;20;20;19;0;8;35;102
sep-18;Politique France;32;38;41;0;9;27;147
sep-18;Sante;17;15;20;0;7;14;73
sep-18;Sciences et techniques;14;5;2;0;3;8;32
sep-18;Societe;88;95;60;0;38;72;353
sep-18;Sport;13;15;12;0;3;30;73
oct-18;Catastrophes;98;98;92;0;7;67;362
oct-18;Culture-loisirs;39;27;17;0;26;59;168
oct-18;Economie;85;67;41;0;8;38;239
oct-18;Education;8;10;7;0;4;11;40
oct-18;Environnement;36;40;32;0;17;16;141
oct-18;Faits divers;22;28;25;0;6;36;117
oct-18;Histoire-hommages;32;27;25;0;10;21;115
oct-18;International;46;84;38;0;150;52;370
oct-18;Justice;21;21;28;0;6;26;102
oct-18;Politique France;32;38;44;0;7;30;151
oct-18;Sante;19;20;21;0;11;30;101
oct-18;Sciences et techniques;14;5;5;0;9;8;41
oct-18;Societe;98;96;69;0;38;80;381
oct-18;Sport;9;11;8;0;0;25;53
nov-18;Catastrophes;22;20;19;0;8;24;93
nov-18;Culture-loisirs;23;23;16;0;21;42;125
nov-18;Economie;80;93;47;0;12;55;287
nov-18;Education;7;5;5;0;1;8;26
nov-18;Environnement;15;14;10;0;8;11;58
nov-18;Faits divers;20;15;24;0;2;27;88
nov-18;Histoire-hommages;24;29;35;0;17;26;131
nov-18;International;26;43;13;0;111;21;214
nov-18;Justice;13;19;19;0;15;23;89
nov-18;Politique France;30;40;35;0;6;32;143
nov-18;Sante;8;9;9;0;4;10;40
nov-18;Sciences et techniques;5;4;0;0;16;9;34
nov-18;Societe;143;128;135;0;23;92;521
nov-18;Sport;9;14;10;0;1;33;67
dec-18;Catastrophes;16;13;15;0;5;15;64
dec-18;Culture-loisirs;19;17;13;0;18;35;102
dec-18;Economie;129;114;79;0;16;67;405
dec-18;Education;10;8;10;0;6;14;48
dec-18;Environnement;13;21;11;0;24;10;79
dec-18;Faits divers;5;7;3;0;1;15;31
dec-18;Histoire-hommages;3;6;8;0;2;8;27
dec-18;International;20;44;14;0;99;23;200
dec-18;Justice;5;14;13;0;6;21;59
dec-18;Politique France;93;125;85;0;16;75;394
dec-18;Sante;4;6;7;0;2;9;28
dec-18;Sciences et techniques;3;5;3;0;5;3;19
dec-18;Societe;136;108;109;0;36;127;516
dec-18;Sport;6;4;3;0;1;10;24
jan-19;Catastrophes;36;43;39;0;5;30;153
jan-19;Culture-loisirs;25;30;29;0;26;58;168
jan-19;Economie;100;90;54;0;9;39;292
jan-19;Education;7;8;3;0;2;8;28
jan-19;Environnement;19;18;18;0;11;25;91
jan-19;Faits divers;28;33;37;0;6;35;139
jan-19;Histoire-hommages;9;14;18;0;15;7;63
jan-19;International;30;58;20;0;142;46;296
jan-19;Justice;14;31;34;0;10;34;123
jan-19;Politique France;88;102;105;0;16;64;375
jan-19;Sante;21;16;13;0;3;21;74
jan-19;Sciences et techniques;17;5;6;0;15;17;60
jan-19;Societe;116;128;77;0;33;91;445
jan-19;Sport;8;12;13;0;0;17;50
feb-19;Catastrophes;28;17;25;0;0;22;92
feb-19;Culture-loisirs;18;28;20;0;29;47;142
feb-19;Economie;85;69;54;0;14;51;273
feb-19;Education;9;5;1;0;1;7;23
feb-19;Environnement;27;20;25;0;9;19;100
feb-19;Faits divers;27;19;25;0;2;38;111
feb-19;Histoire-hommages;6;11;4;0;7;4;32
feb-19;International;30;64;22;0;115;51;282
feb-19;Justice;12;20;27;0;8;29;96
feb-19;Politique France;40;42;50;0;7;31;170
feb-19;Sante;21;16;10;0;3;17;67
feb-19;Sciences et techniques;12;5;4;0;12;6;39
feb-19;Societe;93;132;80;0;30;90;425
feb-19;Sport;7;11;8;0;0;20;46
mar-19;Catastrophes;18;30;26;0;5;19;98
mar-19;Culture-loisirs;24;19;24;0;22;48;137
mar-19;Economie;53;55;36;0;10;20;174
mar-19;Education;11;2;3;0;2;6;24
mar-19;Environnement;27;28;28;0;13;24;120
mar-19;Faits divers;15;12;22;0;1;29;79
mar-19;Histoire-hommages;3;7;2;0;5;3;20
mar-19;International;42;93;48;0;116;55;354
mar-19;Justice;16;24;18;0;15;28;101
mar-19;Politique France;60;51;71;0;10;45;237
mar-19;Sante;24;16;17;0;6;20;83
mar-19;Sciences et techniques;14;6;3;0;7;8;38
mar-19;Societe;94;106;62;0;21;76;359
mar-19;Sport;7;14;5;0;0;30;56
apr-19;Catastrophes;9;7;13;0;2;14;45
apr-19;Culture-loisirs;51;47;29;0;26;69;222
apr-19;Economie;84;76;62;0;5;36;263
apr-19;Education;15;16;5;0;1;13;50
apr-19;Environnement;20;30;19;0;11;17;97
apr-19;Faits divers;90;111;46;0;8;88;343
apr-19;Histoire-hommages;12;11;14;0;12;15;64
apr-19;International;38;77;51;0;169;73;408
apr-19;Justice;13;21;29;0;9;33;105
apr-19;Politique France;58;68;46;0;10;45;227
apr-19;Sante;17;15;18;0;10;20;80
apr-19;Sciences et techniques;17;12;4;0;13;10;56
apr-19;Societe;135;108;95;0;33;106;477
apr-19;Sport;10;16;12;0;1;21;60
may-19;Catastrophes;12;9;10;0;1;9;41
may-19;Culture-loisirs;22;21;33;0;25;54;155
may-19;Economie;88;73;48;0;13;28;250
may-19;Education;9;5;4;0;3;5;26
may-19;Environnement;21;19;23;0;13;15;91
may-19;Faits divers;16;20;25;0;1;25;87
may-19;Histoire-hommages;6;7;10;0;11;3;37
may-19;International;78;82;71;0;156;104;491
may-19;Justice;21;22;28;0;9;31;111
may-19;Politique France;33;40;39;0;6;36;154
may-19;Sante;11;15;10;0;2;13;51
may-19;Sciences et techniques;19;7;9;0;3;10;48
may-19;Societe;70;80;54;0;21;72;297
may-19;Sport;9;11;6;0;0;30;56
jun-19;Catastrophes;50;57;27;0;1;41;176
jun-19;Culture-loisirs;19;22;21;0;23;39;124
jun-19;Economie;50;55;40;0;18;34;197
jun-19;Education;15;16;4;0;3;12;50
jun-19;Environnement;56;52;32;0;19;27;186
jun-19;Faits divers;23;21;28;0;8;33;113
jun-19;Histoire-hommages;26;18;24;0;10;24;102
jun-19;International;18;40;17;0;114;38;227
jun-19;Justice;14;21;19;0;10;20;84
jun-19;Politique France;33;28;30;0;5;21;117
jun-19;Sante;25;19;21;0;13;31;109
jun-19;Sciences et techniques;10;11;3;0;10;6;40
jun-19;Societe;77;84;64;0;19;59;303
jun-19;Sport;52;23;22;0;3;31;131
jul-19;Catastrophes;61;54;52;0;3;58;228
jul-19;Culture-loisirs;25;26;27;0;34;50;162
jul-19;Economie;97;81;49;0;12;30;269
jul-19;Education;19;11;14;0;1;18;63
jul-19;Environnement;85;66;51;0;22;48;272
jul-19;Faits divers;21;18;27;0;0;32;98
jul-19;Histoire-hommages;5;4;3;0;7;5;24
jul-19;International;22;59;29;0;151;39;300
jul-19;Justice;13;17;14;0;10;27;81
jul-19;Politique France;43;64;56;0;9;44;216
jul-19;Sante;25;15;14;0;7;19;80
jul-19;Sciences et techniques;28;19;6;0;12;17;82
jul-19;Societe;101;94;79;0;33;74;381
jul-19;Sport;23;39;45;0;5;35;147
aug-19;Catastrophes;57;55;47;0;13;54;226
aug-19;Culture-loisirs;21;19;22;0;22;39;123
aug-19;Economie;65;63;44;0;6;18;196
aug-19;Education;13;6;6;0;0;11;36
aug-19;Environnement;52;35;29;0;19;22;157
aug-19;Faits divers;34;30;36;0;2;42;144
aug-19;Histoire-hommages;8;13;19;0;8;12;60
aug-19;International;32;84;57;0;141;59;373
aug-19;Justice;7;11;16;0;13;19;66
aug-19;Politique France;21;37;29;0;3;27;117
aug-19;Sante;14;16;6;0;4;13;53
aug-19;Sciences et techniques;18;13;6;0;6;9;52
aug-19;Societe;89;76;49;0;14;73;301
aug-19;Sport;5;12;10;0;1;16;44
sep-19;Catastrophes;46;40;38;0;10;34;168
sep-19;Culture-loisirs;25;17;24;0;19;39;124
sep-19;Economie;64;74;37;0;5;33;213
sep-19;Education;9;9;8;0;2;14;42
sep-19;Environnement;34;41;32;0;20;23;150
sep-19;Faits divers;21;19;20;0;3;26;89
sep-19;Histoire-hommages;28;38;28;0;10;31;135
sep-19;International;20;39;22;0;125;31;237
sep-19;Justice;15;16;23;0;7;27;88
sep-19;Politique France;25;39;33;0;6;29;132
sep-19;Sante;13;23;13;0;4;14;67
sep-19;Sciences et techniques;13;6;4;0;12;8;43
sep-19;Societe;91;95;76;0;20;80;362
sep-19;Sport;20;17;7;0;0;29;73
oct-19;Catastrophes;85;72;76;0;11;57;301
oct-19;Culture-loisirs;26;27;25;0;21;65;164
oct-19;Economie;57;76;36;0;15;46;230
oct-19;Education;5;3;4;0;0;8;20
oct-19;Environnement;25;33;20;0;15;16;109
oct-19;Faits divers;24;28;30;0;5;35;122
oct-19;Histoire-hommages;27;18;20;0;11;21;97
oct-19;International;61;97;52;0;181;78;469
oct-19;Justice;19;20;19;0;9;28;95
oct-19;Politique France;42;49;53;0;8;34;186
oct-19;Sante;19;11;13;0;5;16;64
oct-19;Sciences et techniques;16;8;5;0;12;7;48
oct-19;Societe;99;104;76;0;28;74;381
oct-19;Sport;17;12;11;0;1;34;75
nov-19;Catastrophes;71;62;67;0;5;43;248
nov-19;Culture-loisirs;18;14;15;0;21;42;110
nov-19;Economie;64;47;29;0;14;37;191
nov-19;Education;4;10;3;0;0;7;24
nov-19;Environnement;27;31;14;0;8;16;96
nov-19;Faits divers;16;14;24;0;7;28;89
nov-19;Histoire-hommages;8;16;14;0;12;8;58
nov-19;International;31;50;33;0;110;44;268
nov-19;Justice;12;17;9;0;6;29;73
nov-19;Politique France;17;39;41;0;8;17;122
nov-19;Sante;13;18;12;0;6;8;57
nov-19;Sciences et techniques;9;10;0;0;5;6;30
nov-19;Societe;96;99;83;0;35;85;398
nov-19;Sport;7;9;8;0;3;31;58
dec-19;Catastrophes;45;41;49;0;11;53;199
dec-19;Culture-loisirs;17;16;16;0;17;43;109
dec-19;Economie;46;45;25;0;15;32;163
dec-19;Education;7;7;3;0;1;5;23
dec-19;Environnement;27;22;20;0;15;17;101
dec-19;Faits divers;8;8;11;0;6;19;52
dec-19;Histoire-hommages;7;12;4;0;5;4;32
dec-19;International;16;38;23;0;111;36;224
dec-19;Justice;9;12;13;0;4;16;54
dec-19;Politique France;10;18;16;0;4;19;67
dec-19;Sante;4;3;9;0;5;5;26
dec-19;Sciences et techniques;10;3;7;0;10;7;37
dec-19;Societe;221;236;166;0;38;177;838
dec-19;Sport;2;2;7;0;1;10;22
jan-20;Catastrophes;46;43;30;0;16;36;171
jan-20;Culture-loisirs;15;22;14;0;16;39;106
jan-20;Economie;60;53;36;0;7;33;189
jan-20;Education;5;6;3;0;0;6;20
jan-20;Environnement;18;20;7;0;14;11;70
jan-20;Faits divers;19;14;19;0;2;24;78
jan-20;Histoire-hommages;10;9;10;0;9;11;49
jan-20;International;23;40;21;0;120;36;240
jan-20;Justice;9;20;21;0;8;21;79
jan-20;Politique France;23;35;34;0;4;18;114
jan-20;Sante;47;57;44;0;19;37;204
jan-20;Sciences et techniques;13;8;4;0;7;10;42
jan-20;Societe;128;149;102;0;27;117;523
jan-20;Sport;4;7;9;0;1;11;32
feb-20;Catastrophes;19;24;30;0;2;25;100
feb-20;Culture-loisirs;13;20;18;0;21;46;118
feb-20;Economie;66;60;38;0;8;47;219
feb-20;Education;3;6;1;0;0;2;12
feb-20;Environnement;39;27;19;0;11;21;117
feb-20;Faits divers;13;8;6;0;2;24;53
feb-20;Histoire-hommages;10;8;8;0;7;11;44
feb-20;International;21;37;13;0;107;20;198
feb-20;Justice;10;17;12;0;9;20;68
feb-20;Politique France;29;43;44;0;9;29;154
feb-20;Sante;98;123;108;0;23;104;456
feb-20;Sciences et techniques;15;11;16;0;6;9;57
feb-20;Societe;73;73;36;0;24;49;255
feb-20;Sport;14;25;17;0;2;24;82
mar-20;Catastrophes;9;10;3;0;2;7;31
mar-20;Culture-loisirs;6;6;8;0;15;21;56
mar-20;Economie;44;57;24;0;15;32;172
mar-20;Education;2;4;1;0;1;3;11
mar-20;Environnement;7;7;6;0;4;8;32
mar-20;Faits divers;0;5;0;0;2;7;14
mar-20;Histoire-hommages;3;5;4;0;7;7;26
mar-20;International;9;14;5;0;62;14;104
mar-20;Justice;5;7;11;0;7;9;39
mar-20;Politique France;15;19;23;0;8;14;79
mar-20;Sante;569;511;373;0;107;464;2024
mar-20;Sciences et techniques;4;5;0;0;4;3;16
mar-20;Societe;24;26;17;0;14;23;104
mar-20;Sport;3;3;2;0;1;10;19
apr-20;Catastrophes;0;3;3;0;2;6;14
apr-20;Culture-loisirs;3;6;5;0;3;8;25
apr-20;Economie;97;98;55;0;29;38;317
apr-20;Education;35;26;16;0;2;16;95
apr-20;Environnement;0;3;3;0;2;0;8
apr-20;Faits divers;4;2;1;0;1;3;11
apr-20;Histoire-hommages;4;3;3;0;3;1;14
apr-20;International;0;4;0;0;19;5;28
apr-20;Justice;2;1;1;0;1;1;6
apr-20;Politique France;4;9;3;0;1;6;23
apr-20;Sante;557;475;256;0;127;361;1776
apr-20;Sciences et techniques;0;0;1;0;0;2;3
apr-20;Societe;26;30;21;0;6;19;102
apr-20;Sport;0;0;1;0;0;0;1
may-20;Catastrophes;11;5;4;0;2;12;34
may-20;Culture-loisirs;24;20;19;0;12;36;111
may-20;Economie;124;119;65;0;24;78;410
may-20;Education;43;20;11;0;3;29;106
may-20;Environnement;9;10;5;0;1;5;30
may-20;Faits divers;3;3;2;0;0;4;12
may-20;Histoire-hommages;9;10;13;0;10;9;51
may-20;International;5;15;2;0;35;5;62
may-20;Justice;2;5;5;0;8;4;24
may-20;Politique France;15;14;13;0;5;15;62
may-20;Sante;395;372;188;0;101;281;1337
may-20;Sciences et techniques;9;4;2;0;1;5;21
may-20;Societe;56;47;30;0;13;32;178
may-20;Sport;3;4;2;0;0;3;12
jun-20;Catastrophes;21;15;18;0;1;9;64
jun-20;Culture-loisirs;26;31;29;0;19;63;168
jun-20;Economie;172;128;79;0;31;57;467
jun-20;Education;22;19;9;0;2;14;66
jun-20;Environnement;36;28;15;0;8;24;111
jun-20;Faits divers;21;23;19;0;3;26;92
jun-20;Histoire-hommages;8;6;9;0;8;13;44
jun-20;International;12;26;6;0;75;16;135
jun-20;Justice;16;20;21;0;11;28;96
jun-20;Politique France;76;84;68;0;8;105;341
jun-20;Sante;162;161;90;0;59;127;599
jun-20;Sciences et techniques;15;16;8;0;7;11;57
jun-20;Societe;114;90;63;0;53;98;418
jun-20;Sport;3;3;2;0;0;10;18
jul-20;Catastrophes;13;12;9;0;3;20;57
jul-20;Culture-loisirs;26;36;23;0;19;41;145
jul-20;Economie;83;77;64;0;24;29;277
jul-20;Education;5;4;0;0;1;5;15
jul-20;Environnement;33;26;21;0;6;11;97
jul-20;Faits divers;32;22;29;0;4;45;132
jul-20;Histoire-hommages;6;8;7;0;6;7;34
jul-20;International;3;21;4;0;72;17;117
jul-20;Justice;5;8;4;0;11;13;41
jul-20;Politique France;59;59;46;0;9;32;205
jul-20;Sante;160;127;72;0;36;87;482
jul-20;Sciences et techniques;6;9;4;0;7;12;38
jul-20;Societe;89;42;44;0;24;48;247
jul-20;Sport;5;9;6;0;0;24;44
aug-20;Catastrophes;63;78;58;0;21;59;279
aug-20;Culture-loisirs;24;28;21;0;16;44;133
aug-20;Economie;63;54;36;0;14;27;194
aug-20;Education;11;11;8;0;3;12;45
aug-20;Environnement;59;37;33;0;16;24;169
aug-20;Faits divers;12;10;13;0;1;14;50
aug-20;Histoire-hommages;2;4;0;0;7;4;17
aug-20;International;26;58;32;0;93;36;245
aug-20;Justice;6;7;8;0;4;5;30
aug-20;Politique France;12;19;11;0;3;5;50
aug-20;Sante;190;95;78;0;18;87;468
aug-20;Sciences et techniques;11;5;2;0;8;9;35
aug-20;Societe;53;60;36;0;24;50;223
aug-20;Sport;23;30;29;0;1;26;109
sep-20;Catastrophes;47;34;40;0;7;45;173
sep-20;Culture-loisirs;21;24;22;0;25;49;141
sep-20;Economie;86;99;58;0;7;43;293
sep-20;Education;36;25;20;0;0;23;104
sep-20;Environnement;36;35;14;0;14;13;112
sep-20;Faits divers;28;13;15;0;4;27;87
sep-20;Histoire-hommages;14;21;13;0;4;11;63
sep-20;International;30;47;17;0;128;42;264
sep-20;Justice;12;28;15;0;11;22;88
sep-20;Politique France;33;39;42;0;11;35;160
sep-20;Sante;230;162;121;0;38;113;664
sep-20;Sciences et techniques;8;4;6;0;8;8;34
sep-20;Societe;73;56;38;0;26;57;250
sep-20;Sport;13;24;33;0;1;30;101
jan-21;Catastrophes;32;20;20;0;4;20;96
jan-21;Culture-loisirs;10;13;11;0;13;33;80
jan-21;Economie;75;48;48;0;12;45;228
jan-21;Education;10;12;8;0;3;14;47
jan-21;Environnement;35;16;17;0;5;11;84
jan-21;Faits divers;17;11;14;0;1;21;64
jan-21;Histoire-hommages;9;12;8;0;4;6;39
jan-21;International;43;60;29;0;84;60;276
jan-21;Justice;6;9;10;0;8;17;50
jan-21;Politique France;6;13;5;0;2;8;34
jan-21;Sante;260;230;165;0;62;129;846
jan-21;Sciences et techniques;11;6;6;0;1;7;31
jan-21;Societe;35;25;23;0;22;47;152
jan-21;Sport;4;7;4;0;0;20;35
feb-21;Catastrophes;74;53;42;0;2;35;206
feb-21;Culture-loisirs;18;13;19;0;31;39;120
feb-21;Economie;73;58;54;0;6;49;240
feb-21;Education;8;9;7;0;1;14;39
feb-21;Environnement;46;26;18;0;4;19;113
feb-21;Faits divers;22;20;15;0;0;29;86
feb-21;Histoire-hommages;5;5;3;0;3;6;22
feb-21;International;9;27;9;0;91;28;164
feb-21;Justice;11;12;12;0;10;23;68
feb-21;Politique France;3;13;7;0;5;5;33
feb-21;Sante;203;185;118;0;42;91;639
feb-21;Sciences et techniques;21;10;5;0;10;8;54
feb-21;Societe;44;44;31;0;19;51;189
feb-21;Sport;8;9;8;0;0;28;53
mar-21;Catastrophes;10;8;3;0;3;7;31
mar-21;Culture-loisirs;16;22;21;0;28;51;138
mar-21;Economie;84;69;76;0;14;53;296
mar-21;Education;84;69;76;0;14;53;296
mar-21;Environnement;13;18;7;0;1;14;53
mar-21;Faits divers;27;14;15;0;8;14;78
mar-21;Histoire-hommages;28;20;21;0;3;38;110
mar-21;International;17;33;6;0;118;24;198
mar-21;Justice;18;29;20;0;17;25;109
mar-21;Politique France;6;16;12;0;7;18;59
mar-21;Sante;311;277;206;0;56;174;1024
mar-21;Sciences et techniques;21;18;10;0;7;9;65
mar-21;Societe;73;64;40;0;27;82;286
mar-21;Sport;12;12;6;0;0;28;58
